"label"	"description"
"Accounts Payable (Deprecated 2009-01-31)"	"Carrying value as of the balance sheet date of liabilities incurred (and for which invoices have typically been received) and payable to vendors for goods and services received that are used in an entity's business. For classified balance sheets, used to reflect the current portion of the liabilities (due within one year or within the normal operating cycle if longer); for unclassified balance sheets, used to reflect the total liabilities (regardless of due date)."
"Accounts Payable, Current"	"Carrying value as of the balance sheet date of liabilities incurred (and for which invoices have typically been received) and payable to vendors for goods and services received that are used in an entity's business. Used to reflect the current portion of the liabilities (due within one year or within the normal operating cycle if longer)."
"Accounts Receivable, after Allowance for Credit Loss, Current"	"Amount, after allowance for credit loss, of right to consideration from customer for product sold and service rendered in normal course of business, classified as current."
"Accrued Income Taxes, Current"	"Carrying amount as of the balance sheet date of the unpaid sum of the known and estimated amounts payable to satisfy all currently due domestic and foreign income tax obligations."
"Accrued Income Taxes, Noncurrent"	"Carrying amount as of the balance sheet date of the unpaid sum of the known and estimated amounts payable to satisfy all domestic and foreign income tax obligations due beyond one year or the operating cycle, whichever is longer. Alternate captions include income taxes payable, noncurrent."
"Accrued Liabilities (Deprecated 2009-01-31)"	"Carrying value as of the balance sheet date of obligations incurred and payable, pertaining to costs that are statutory in nature, are incurred on contractual obligations, or accumulate over time and for which invoices have not yet been received or will not be rendered. Examples include taxes, interest, rent and utilities. For classified balance sheets, used to reflect the current portion of the liabilities (due within one year or within the normal operating cycle if longer); for unclassified balance sheets, used to reflect the total liabilities (regardless of due date)."
"Accrued Liabilities, Current"	"Carrying value as of the balance sheet date of obligations incurred and payable, pertaining to costs that are statutory in nature, are incurred on contractual obligations, or accumulate over time and for which invoices have not yet been received or will not be rendered. Examples include taxes, interest, rent and utilities. Used to reflect the current portion of the liabilities (due within one year or within the normal operating cycle if longer)."
"Accrued Marketing Costs, Current"	"Carrying value as of the balance sheet date of obligations incurred through that date and payable for the marketing, trade and selling of the entity's goods and services. Marketing costs would include expenditures for planning and executing the conception, pricing, promotion, and distribution of ideas, goods, and services; costs of public relations and corporate promotions; and obligations incurred and payable for sales discounts, rebates, price protection programs, etc. offered to customers and under government programs. Used to reflect the current portion of the liabilities (due within one year or within the normal operating cycle if longer)."
"Accumulated Depreciation, Depletion and Amortization, Property, Plant, and Equipment"	"Amount of accumulated depreciation, depletion and amortization for physical assets used in the normal conduct of business to produce goods and services."
"AOCI, Debt Securities, Available-for-sale, Adjustment, after Tax"	"Amount, after tax, of accumulated unrealized gain (loss) on investment in debt security measured at fair value with change in fair value recognized in other comprehensive income (available-for-sale)."
"Accumulated Other Comprehensive Income (Loss), Cumulative Changes in Net Gain (Loss) from Cash Flow Hedges, Effect Net of Tax"	"Accumulated change, net of tax, in accumulated gains and losses from derivative instruments designated and qualifying as the effective portion of cash flow hedges. Includes an entity's share of an equity investee's Increase or Decrease in deferred hedging gains or losses."
"Accumulated Other Comprehensive Income (Loss), Foreign Currency Translation Adjustment, Net of Tax"	"Accumulated adjustment, net of tax, that results from the process of translating subsidiary financial statements and foreign equity investments into the reporting currency from the functional currency of the reporting entity, net of reclassification of realized foreign currency translation gains or losses."
"Accumulated Other Comprehensive Income (Loss), Net of Tax"	"Accumulated change in equity from transactions and other events and circumstances from non-owner sources, net of tax effect, at period end. Excludes Net Income (Loss), and accumulated changes in equity from transactions resulting from investments by owners and distributions to owners. Includes foreign currency translation items, certain pension adjustments, unrealized gains and losses on certain investments in debt and equity securities, other than temporary impairment (OTTI) losses related to factors other than credit losses on available-for-sale and held-to-maturity debt securities that an entity does not intend to sell and it is not more likely than not that the entity will be required to sell before recovery of the amortized cost basis, as well as changes in the fair value of derivatives related to the effective portion of a designated cash flow hedge."
"APIC, Share-based Payment Arrangement, Increase for Cost Recognition"	"Amount of increase to additional paid-in capital (APIC) for recognition of cost for award under share-based payment arrangement."
"Adjustments to Additional Paid in Capital, Income Tax Benefit from Share-based Compensation"	"Amount of increase in additional paid in capital (APIC) resulting from a tax benefit associated with share-based compensation plan other than an employee stock ownership plan (ESOP). Includes, but is not limited to, excess tax benefit."
"Advertising Expense"	"Amount charged to advertising expense for the period, which are expenses incurred with the objective of increasing revenue for a specified brand, product or product line."
"Share-based Payment Arrangement, Expense"	"Amount of expense for award under share-based payment arrangement. Excludes amount capitalized."
"Accounts Receivable, Allowance for Credit Loss, Current"	"Amount of allowance for credit loss on accounts receivable, classified as current."
"Amortization of Intangible Assets"	"The aggregate expense charged against earnings to allocate the cost of intangible assets (nonphysical assets not used in production) in a systematic and rational manner to the periods expected to benefit from such assets. As a noncash expense, this element is added back to net income when calculating cash provided by or used in operations using the indirect method."
"Antidilutive Securities Excluded from Computation of Earnings Per Share, Amount"	"Securities (including those issuable pursuant to contingent stock agreements) that could potentially dilute basic earnings per share (EPS) or earnings per unit (EPU) in the future that were not included in the computation of diluted EPS or EPU because to do so would increase EPS or EPU amounts or decrease loss per share or unit amounts for the period presented."
"Assets"	"Sum of the carrying amounts as of the balance sheet date of all assets that are recognized. Assets are probable future economic benefits obtained or controlled by an entity as a result of past transactions or events."
"Assets, Current"	"Sum of the carrying amounts as of the balance sheet date of all assets that are expected to be realized in cash, sold, or consumed within one year (or the normal operating cycle, if longer). Assets are probable future economic benefits obtained or controlled by an entity as a result of past transactions or events."
"Assets, Noncurrent"	"Sum of the carrying amounts as of the balance sheet date of all assets that are expected to be realized in cash, sold or consumed after one year or beyond the normal operating cycle, if longer."
"Debt Securities, Available-for-sale, Accumulated Gross Unrealized Gain, before Tax"	"Amount, before tax, of unrealized gain in accumulated other comprehensive income (AOCI) on investment in debt security measured at fair value with change in fair value recognized in other comprehensive income (available-for-sale)."
"Debt Securities, Available-for-sale, Accumulated Gross Unrealized Loss, before Tax"	"Amount, before tax, of unrealized loss in accumulated other comprehensive income (AOCI) on investment in debt security measured at fair value with change in fair value recognized in other comprehensive income (available-for-sale)."
"Debt Securities, Available-for-sale, Amortized Cost"	"Amortized cost of investment in debt security measured at fair value with change in fair value recognized in other comprehensive income (available-for-sale)."
"Available-for-sale Securities"	"Amount of investment in debt and equity securities categorized neither as held-to-maturity nor trading."
"Available-for-sale Securities, Accumulated Gross Unrealized Gain, before Tax"	"Amount before tax of unrealized gain in accumulated other comprehensive income (AOCI) on investments in debt and equity securities classified as available-for-sale."
"Available-for-sale Securities, Accumulated Gross Unrealized Loss, before Tax"	"Amount before tax of unrealized loss in accumulated other comprehensive income (AOCI) on investments in debt and equity securities classified as available-for-sale."
"Available-for-sale Securities, Amortized Cost Basis"	"This item represents the cost of debt and equity securities, which are categorized neither as held-to-maturity nor trading, net of adjustments including accretion, amortization, collection of cash, previous other-than-temporary impairments recognized in earnings (less any cumulative-effect adjustments recognized, as defined), and fair value hedge accounting adjustments, if any."
"Available-for-sale Securities, Continuous Unrealized Loss Position, 12 Months or Longer, Accumulated Loss"	"Amount of accumulated unrealized loss on investments in debt and equity securities classified as available-for-sale that have been in a continuous loss position for twelve months or longer."
"Available-for-sale Securities, Continuous Unrealized Loss Position, Accumulated Loss"	"Amount of accumulated unrealized loss on investments in debt and equity securities classified as available-for-sale in a continuous loss position."
"Available-for-sale Securities, Continuous Unrealized Loss Position, Fair Value"	"This item represents the aggregate fair value of investments in debt and equity securities in an unrealized loss position which are categorized neither as held-to-maturity nor trading securities."
"Available-for-sale Securities, Continuous Unrealized Loss Position, Less than 12 Months, Accumulated Loss"	"Amount of accumulated unrealized loss on investments in debt and equity securities classified as available-for-sale that have been in a continuous loss position for less than twelve months."
"Available-for-sale Securities, Continuous Unrealized Loss Position, Less than Twelve Months, Fair Value"	"This item represents the aggregate fair value of investments in debt and equity securities categorized neither as held-to-maturity nor trading securities that have been in a continuous unrealized loss position for less than twelve months."
"Available-for-sale Securities, Continuous Unrealized Loss Position, Twelve Months or Longer, Fair Value"	"This item represents the aggregate fair value of investments in debt and equity securities categorized neither as held-to-maturity nor trading securities that have been in a continuous unrealized loss position for twelve months or longer."
"Available-for-sale Securities, Current"	"Amount of investment in debt and equity securities categorized neither as trading securities nor held-to-maturity securities and intended be sold or mature one year or operating cycle, if longer."
"Debt Securities, Available-for-sale, Maturity, Allocated and Single Maturity Date, Rolling after 10 Years, Fair Value"	"Fair value of investment in debt security measured at fair value with change in fair value recognized in other comprehensive income (available-for-sale), with single maturity date and allocated without single maturity date, maturing after rolling tenth fiscal year following latest fiscal year. For interim and annual periods when interim period is reported on rolling approach, from latest statement of financial position date."
"Debt Securities, Available-for-sale, Maturity, Allocated and Single Maturity Date, Rolling after Five Through Ten Years, Fair Value"	"Fair value of investment in debt security, measured at fair value with change in fair value recognized in other comprehensive income (available-for-sale), with single maturity date and allocated without single maturity date, maturing in rolling sixth through tenth fiscal year following latest fiscal year. For interim and annual periods when interim period is reported on rolling approach, from latest statement of financial position date."
"Debt Securities, Available-for-sale, Maturity, Allocated and Single Maturity Date, Rolling after One Through Five Years, Fair Value"	"Fair value of investment in debt security, measured at fair value with change in fair value recognized in other comprehensive income (available-for-sale), with single maturity date and allocated without single maturity date, maturing in next rolling fiscal year through fifth year following latest fiscal year. For interim and annual periods when interim period is reported on rolling approach, from latest statement of financial position date."
"Debt Securities, Available-for-sale, Maturity, Allocated and Single Maturity Date, Fair Value"	"Fair value of investment in debt security measured at fair value with change in fair value recognized in other comprehensive income (available-for-sale), with single maturity date and allocated without single maturity date."
"Debt Securities, Available-for-sale"	"Amount of investment in debt security measured at fair value with change in fair value recognized in other comprehensive income (available-for-sale)."
"Debt Securities, Available-for-sale, Current"	"Amount of investment in debt security measured at fair value with change in fair value recognized in other comprehensive income (available-for-sale), classified as current."
"Debt Securities, Available-for-sale, Noncurrent"	"Amount of investment in debt security measured at fair value with change in fair value recognized in other comprehensive income (available-for-sale), classified as noncurrent."
"Available-for-sale Securities, Fair Value Disclosure (Deprecated 2013-01-31)"	"This element represents the portion of the balance sheet assertion valued at fair value by the entity whether such amount is presented as a separate caption or as a parenthetical disclosure. Additionally, this element may be used in connection with the fair value disclosures required in the footnote disclosures to the financial statements. The element may be used in both the balance sheet and disclosure in the same submission. This item represents Available-for-sale Securities which consist of all investments in certain debt and equity securities neither classified as trading or held-to-maturity securities. A debt security represents a creditor relationship with an enterprise. Debt securities include, among other items, US Treasury securities, US government securities, municipal securities, corporate bonds, convertible debt, commercial paper, and all securitized debt instruments. An equity security represents an ownership interest in an enterprise or the right to acquire or dispose of an ownership interest in an enterprise at fixed or determinable prices. Equity securities include, among other things, common stock, certain preferred stock, warrant rights, call options, and put options, but do not include convertible debt. An entity may opt to provide the reader with additional narrative text to better understand the nature of investments in debt and equity securities which are categorized as Available-for-sale."
"Available-for-sale Securities, Gross Unrealized Losses (Deprecated 2013-01-31)"	"This item represents the gross unrealized losses for securities, at a point in time, which are categorized neither as held-to-maturity nor trading securities."
"Available-for-sale Securities, Noncurrent"	"Investments in debt and equity securities which are categorized neither as held-to-maturity nor trading and which are intended to be sold or mature more than one year from the balance sheet date or operating cycle, if longer. Such securities are reported at fair value; unrealized gains (losses) related to Available-for-sale Securities are excluded from earnings and reported in a separate component of shareholders' equity (other comprehensive income), unless the Available-for-sale security is designated as a hedge or is determined to have had an other than temporary decline in fair value below its amortized cost basis. All or a portion of the unrealized holding gain (loss) of an Available-for-sale security that is designated as being hedged in a fair value hedge is recognized in earnings during the period of the hedge, as are other than temporary declines in fair value below the cost basis for investments in equity securities and debt securities that an entity intends to sell or it is more likely than not that it will be required to sell before the recovery of its amortized cost basis. Other than temporary declines in fair value below the cost basis for debt securities categorized as Available-for-sale that an entity does not intend to sell and for which it is not more likely than not that the entity will be required to sell before the recovery of its amortized cost basis are bifurcated into credit losses and losses related to all other factors. Other than temporary declines in fair value below cost basis related to credit losses are recognized in earnings, and losses related to all other factors are recognized in other comprehensive income."
"Available-for-sale Securities, Gross Unrealized Gains (Deprecated 2013-01-31)"	"This item represents the gross unrealized gains for securities, at a point in time, which are categorized neither as held-to-maturity nor trading securities."
"Business Acquisition, Cost of Acquired Entity, Purchase Price (Deprecated 2013-01-31)"	"The total cost of the acquired entity including the cash paid to shareholders of acquired entities, fair value of debt and equity securities issued to shareholders of acquired entities, the fair value of the liabilities assumed, and direct costs of the acquisition."
"Business Acquisition, Purchase Price Allocation, Amortizable Intangible Assets (Deprecated 2013-01-31)"	"The amount of acquisition cost of a business combination allocated to an identifiable intangible asset that will be amortized."
"Business Acquisition, Purchase Price Allocation, Goodwill Amount (Deprecated 2013-01-31)"	"Amount of goodwill arising from a business combination, which is the excess of the cost of the acquired entity over the amounts assigned to assets acquired and liabilities assumed."
"Business Acquisition, Purchase Price Allocation, Liabilities Assumed (Deprecated 2013-01-31)"	"The amount of acquisition cost of a business combination allocated to liabilities assumed."
"Business Combination, Recognized Identifiable Assets Acquired and Liabilities Assumed, Intangible Assets, Other than Goodwill"	"Amount of intangible assets, excluding goodwill, acquired at the acquisition date."
"Business Combination, Recognized Identifiable Assets Acquired and Liabilities Assumed, Liabilities"	"Amount of liabilities assumed at the acquisition date."
"Capital Expenditures Incurred but Not yet Paid"	"Future cash outflow to pay for purchases of fixed assets that have occurred."
"Capitalized Computer Software, Additions"	"Additions made to capitalized computer software costs during the period."
"Capitalized Computer Software, Amortization (Deprecated 2016-01-31)"	"For each income statement presented, the amount charged to expense for amortization of capitalized computer software costs."
"Cash"	"Amount of currency on hand as well as demand deposits with banks or financial institutions. Includes other kinds of accounts that have the general characteristics of demand deposits. Excludes cash and cash equivalents within disposal group and discontinued operation."
"Cash and Cash Equivalents, at Carrying Value"	"Amount of currency on hand as well as demand deposits with banks or financial institutions. Includes other kinds of accounts that have the general characteristics of demand deposits. Also includes short-term, highly liquid investments that are both readily convertible to known amounts of cash and so near their maturity that they present insignificant risk of changes in value because of changes in interest rates. Excludes cash and cash equivalents within disposal group and discontinued operation."
"Cash and Cash Equivalents, Period Increase (Decrease)"	"Amount of increase (decrease) in cash and cash equivalents. Cash and cash equivalents are the amount of currency on hand as well as demand deposits with banks or financial institutions. Includes other kinds of accounts that have the general characteristics of demand deposits. Also includes short-term, highly liquid investments that are both readily convertible to known amounts of cash and so near their maturity that they present insignificant risk of changes in value because of changes in interest rates. Includes effect from exchange rate changes."
"Cash, Cash Equivalents, Restricted Cash and Restricted Cash Equivalents"	"Amount of cash and cash equivalents, and cash and cash equivalents restricted to withdrawal or usage. Excludes amount for disposal group and discontinued operations. Cash includes, but is not limited to, currency on hand, demand deposits with banks or financial institutions, and other accounts with general characteristics of demand deposits. Cash equivalents include, but are not limited to, short-term, highly liquid investments that are both readily convertible to known amounts of cash and so near their maturity that they present insignificant risk of changes in value because of changes in interest rates."
"Cash, Cash Equivalents, Restricted Cash and Restricted Cash Equivalents, Period Increase (Decrease), Including Exchange Rate Effect"	"Amount of increase (decrease) in cash, cash equivalents, and cash and cash equivalents restricted to withdrawal or usage; including effect from exchange rate change. Cash includes, but is not limited to, currency on hand, demand deposits with banks or financial institutions, and other accounts with general characteristics of demand deposits. Cash equivalents include, but are not limited to, short-term, highly liquid investments that are both readily convertible to known amounts of cash and so near their maturity that they present insignificant risk of changes in value because of changes in interest rates."
"Cash Equivalents, at Carrying Value"	"Amount of short-term, highly liquid investments that are both readily convertible to known amounts of cash and so near their maturity that they present insignificant risk of changes in value because of changes in interest rates. Excludes cash and cash equivalents within disposal group and discontinued operation."
"Change in Unrealized Gain (Loss) on Fair Value Hedging Instruments (Deprecated 2013-01-31)"	"The amount recognized in earnings related to the change in fair value during the period of derivative or nonderivative instruments designated as fair value hedging instruments."
"Collateral Already Posted, Aggregate Fair Value"	"The aggregate fair value of assets that are already posted, at the end of the reporting period, as collateral for derivative instruments with credit-risk-related contingent features."
"Commercial Paper"	"Carrying value as of the balance sheet date of short-term borrowings using unsecured obligations issued by banks, corporations and other borrowers to investors. The maturities of these money market securities generally do not exceed 270 days."
"Commitments and Contingencies"	"Represents the caption on the face of the balance sheet to indicate that the entity has entered into (1) purchase or supply arrangements that will require expending a portion of its resources to meet the terms thereof, and (2) is exposed to potential losses or, less frequently, gains, arising from (a) possible claims against a company's resources due to future performance under contract terms, and (b) possible losses or likely gains from uncertainties that will ultimately be resolved when one or more future events that are deemed likely to occur do occur or fail to occur."
"Common Stock, Dividends, Per Share, Cash Paid"	"Aggregate dividends paid during the period for each share of common stock outstanding."
"Common Stock, Dividends, Per Share, Declared"	"Aggregate dividends declared during the period for each share of common stock outstanding."
"Common Stock, No Par Value"	"Face amount per share of no-par value common stock."
"Common Stock, Par or Stated Value Per Share"	"Face amount or stated value per share of common stock."
"Common Stock, Shares Authorized"	"The maximum number of common shares permitted to be issued by an entity's charter and bylaws."
"Common Stock, Shares, Issued"	"Total number of common shares of an entity that have been sold or granted to shareholders (includes common shares that were issued, repurchased and remain in the treasury). These shares represent capital invested by the firm's shareholders and owners, and may be all or only a portion of the number of shares authorized. Shares issued include shares outstanding and shares held in the treasury."
"Common Stock, Shares, Outstanding"	"Number of shares of common stock outstanding. Common stock represent the ownership interest in a corporation."
"Common Stocks, Including Additional Paid in Capital"	"Amount of par value plus amounts in excess of par value or issuance value for common stock issued."
"Common Stock, Value, Issued"	"Aggregate par or stated value of issued nonredeemable common stock (or common stock redeemable solely at the option of the issuer). This item includes treasury stock repurchased by the entity. Note: elements for number of nonredeemable common shares, par value and other disclosure concepts are in another section within stockholders' equity."
"Comprehensive Income (Loss), Net of Tax, Attributable to Parent"	"Amount after tax of increase (decrease) in equity from transactions and other events and circumstances from net income and other comprehensive income, attributable to parent entity. Excludes changes in equity resulting from investments by owners and distributions to owners."
"Contract with Customer, Liability"	"Amount of obligation to transfer good or service to customer for which consideration has been received or is receivable."
"Contract with Customer, Liability, Current"	"Amount of obligation to transfer good or service to customer for which consideration has been received or is receivable, classified as current."
"Contract with Customer, Liability, Revenue Recognized"	"Amount of revenue recognized that was previously included in balance of obligation to transfer good or service to customer for which consideration from customer has been received or is due."
"Cost of Goods and Services Sold"	"The aggregate costs related to goods produced and sold and services rendered by an entity during the reporting period. This excludes costs incurred during the reporting period related to financial services rendered and other revenue generating activities."
"Cost, Depreciation"	"Amount of expense for allocation of cost of tangible asset over its useful life directly used in production of good and rendering of service."
"Cost of Reimbursable Expense (Deprecated 2018-01-31)"	"Cost associated with reimbursable income. This occurs when a services entity incurs expenses on behalf of the client and passes through the cost of reimbursable expenses to a client."
"Cumulative Effect of Initial Adoption of FIN 48 (Deprecated 2011-01-31)"	"Cumulative net-of-tax effect of initial adoption of FIN 48 - Accounting for Uncertainty in Income Taxes on the opening balance of retained earnings. The cumulative-effect adjustment does not include items that would not be recognized in earnings, such as the effect of adopting this Interpretation on tax positions related to business combinations. The amount of that cumulative-effect adjustment is the difference between the net amount of assets and liabilities recognized in the statement of financial position prior to the application of this Interpretation and the net amount of assets and liabilities recognized as a result of applying the provisions of this Interpretation."
"Cumulative Effect of Initial Adoption of New Accounting Principle (Deprecated 2011-01-31)"	"Cumulative effect of initial adoption of new accounting principle on beginning retained earnings, net of tax. This element can be used, generally, for the adjustment to retained earnings of a new accounting principle."
"Current Federal Tax Expense (Benefit)"	"Amount of current federal tax expense (benefit) pertaining to income (loss) from continuing operations."
"Current Foreign Tax Expense (Benefit)"	"Amount of current foreign income tax expense (benefit) pertaining to income (loss) from continuing operations."
"Current State and Local Tax Expense (Benefit)"	"Amount of current state and local tax expense (benefit) pertaining to income (loss) from continuing operations."
"Long-term Debt, Gross"	"Amount, before unamortized (discount) premium and debt issuance costs, of long-term debt. Includes, but is not limited to, notes payable, bonds payable, commercial loans, mortgage loans, convertible debt, subordinated debt and other types of debt."
"Debt Instrument, Unamortized Discount"	"Amount, after accumulated amortization, of debt discount."
"Debt Instrument, Unamortized Discount (Premium) and Debt Issuance Costs, Net"	"Amount of unamortized debt discount (premium) and debt issuance costs."
"Debt Instrument, Unamortized Discount (Premium), Net"	"Amount, after accumulated amortization, of debt discount (premium)."
"Debt Securities, Available-for-sale, Continuous Unrealized Loss Position, 12 Months or Longer"	"Amount of investment in debt security measured at fair value with change in fair value recognized in other comprehensive income (available-for-sale), in continuous unrealized loss position for more than 12 months, without allowance for credit loss. Includes beneficial interest in securitized financial asset."
"Debt Securities, Available-for-sale, Continuous Unrealized Loss Position, 12 Months or Longer, Accumulated Loss"	"Amount of accumulated unrealized loss on investment in debt security measured at fair value with change in fair value recognized in other comprehensive income (available-for-sale), in continuous unrealized loss position for 12 months or longer, without allowance for credit loss. Includes beneficial interest in securitized financial asset."
"Debt Securities, Available-for-sale, Continuous Unrealized Loss Position, Less than 12 Months"	"Amount of investment in debt security measured at fair value with change in fair value recognized in other comprehensive income (available-for-sale), in continuous unrealized loss position for less than 12 months, without allowance for credit loss. Includes beneficial interest in securitized financial asset."
"Debt Securities, Available-for-sale, Continuous Unrealized Loss Position, Less than 12 Months, Accumulated Loss"	"Amount of accumulated unrealized loss on investment in debt security measured at fair value with change in fair value recognized in other comprehensive income (available-for-sale), in continuous unrealized loss position for less than 12 months, without allowance for credit loss. Includes beneficial interest in securitized financial asset."
"Debt Securities, Available-for-sale, Unrealized Loss Position"	"Amount of investment in debt security measured at fair value with change in fair value recognized in other comprehensive income (available-for-sale), in unrealized loss position without allowance for credit loss."
"Debt Securities, Available-for-sale, Unrealized Loss Position, Accumulated Loss"	"Amount of accumulated unrealized loss on investment in debt security measured at fair value with change in fair value recognized in other comprehensive income (available-for-sale), in unrealized loss position, without allowance for credit loss. Includes beneficial interest in securitized financial asset."
"Decrease in Unrecognized Tax Benefits is Reasonably Possible"	"Amount of decrease reasonably possible in the next twelve months for the unrecognized tax benefit."
"Deferred Federal Income Tax Expense (Benefit)"	"Amount of deferred federal income tax expense (benefit) pertaining to income (loss) from continuing operations."
"Deferred Foreign Income Tax Expense (Benefit)"	"Amount of deferred foreign income tax expense (benefit) pertaining to income (loss) from continuing operations."
"Deferred Income Tax Expense (Benefit)"	"Amount of deferred income tax expense (benefit) pertaining to income (loss) from continuing operations."
"Deferred Tax Liabilities, Gross"	"Amount of deferred tax liability attributable to taxable temporary differences."
"Deferred Income Tax Liabilities, Net"	"Amount, after deferred tax asset, of deferred tax liability attributable to taxable differences with jurisdictional netting."
"Deferred Revenue, Current"	"Amount of deferred income and obligation to transfer product and service to customer for which consideration has been received or is receivable, classified as current."
"Deferred Revenue, Noncurrent"	"Amount of deferred income and obligation to transfer product and service to customer for which consideration has been received or is receivable, classified as noncurrent."
"Deferred State and Local Income Tax Expense (Benefit)"	"Amount of deferred state and local tax expense (benefit) pertaining to income (loss) from continuing operations."
"Deferred Tax Assets, Deferred Income"	"Amount before allocation of valuation allowances of deferred tax asset attributable to deductible temporary differences from deferred income."
"Deferred Tax Assets, Goodwill and Intangible Assets"	"Amount before allocation of valuation allowances of deferred tax asset attributable to deductible temporary differences from intangible assets including goodwill."
"Deferred Tax Assets, Gross"	"Amount before allocation of valuation allowances of deferred tax asset attributable to deductible temporary differences and carryforwards."
"Deferred Tax Assets, Net"	"Amount, after allocation of valuation allowances and deferred tax liability, of deferred tax asset attributable to deductible differences and carryforwards, without jurisdictional netting."
"Deferred Tax Assets, Net, Current"	"Amount, after allocation of valuation allowances and deferred tax liability, of deferred tax asset attributable to deductible differences and carryforwards, netted by jurisdiction and classified as current."
"Deferred Tax Assets, Net of Valuation Allowance"	"Amount after allocation of valuation allowances of deferred tax asset attributable to deductible temporary differences and carryforwards."
"Deferred Tax Assets, Net of Valuation Allowance, Current"	"Amount after allocation of valuation allowances of deferred tax asset attributable to deductible temporary differences and carryforwards classified as current."
"Deferred Tax Assets, Other"	"Amount, before allocation of valuation allowance, of deferred tax asset attributable to deductible temporary differences, classified as other."
"Deferred Tax Assets, Property, Plant and Equipment"	"Amount before allocation of valuation allowances of deferred tax asset attributable to deductible temporary differences from property, plant, and equipment."
"Deferred Tax Assets, Tax Credit Carryforwards"	"Amount, before allocation of a valuation allowances, of deferred tax assets attributable to deductible tax credit carryforwards including, but not limited to, research, foreign, general business, alternative minimum tax, and other deductible tax credit carryforwards."
"Deferred Tax Assets, Tax Credit Carryforwards, Foreign"	"Amount before allocation of valuation allowances of deferred tax asset attributable to deductible foreign tax credit carryforwards."
"Deferred Tax Assets, Tax Credit Carryforwards, Research"	"Amount before allocation of valuation allowances of deferred tax asset attributable to deductible research tax credit carryforwards."
"Deferred Tax Assets, Tax Deferred Expense, Compensation and Benefits, Share-based Compensation Cost"	"Amount before allocation of valuation allowances of deferred tax asset attributable to deductible temporary differences from share-based compensation."
"Deferred Tax Assets, Tax Deferred Expense, Reserves and Accruals"	"Amount before allocation of valuation allowances of deferred tax asset attributable to deductible temporary differences from reserves and accruals."
"Deferred Tax Assets, Unrealized Losses on Available-for-Sale Securities, Gross"	"Amount before allocation of valuation allowances of deferred tax asset attributable to deductible temporary differences from unrealized losses on available-for-sale securities."
"Deferred Tax Assets, Valuation Allowance"	"Amount of deferred tax assets for which it is more likely than not that a tax benefit will not be realized."
"Deferred Tax Liabilities, Net"	"Amount, after deferred tax asset, of deferred tax liability attributable to taxable differences without jurisdictional netting."
"Deferred Tax Liabilities, Leasing Arrangements"	"Amount of deferred tax liability attributable to taxable temporary differences from leasing arrangements."
"Deferred Tax Liabilities, Net, Noncurrent"	"Amount, after deferred tax asset, of deferred tax liability attributable to taxable differences, with jurisdictional netting and classified as noncurrent."
"Deferred Tax Liabilities, Other"	"Amount of deferred tax liability attributable to taxable temporary differences classified as other."
"Deferred Tax Liabilities, Other Comprehensive Income"	"Amount of deferred tax liability attributable to taxable temporary differences from unrealized gains in other comprehensive income."
"Deferred Tax Liabilities, Undistributed Foreign Earnings"	"Amount of deferred tax liability attributable to taxable temporary differences from undistributed earnings of subsidiary and other recognized entity not within country of domicile. Includes, but is not limited to, other basis differences."
"Deferred Tax Liability Not Recognized, Amount of Unrecognized Deferred Tax Liability, Undistributed Earnings of Foreign Subsidiaries"	"Amount of deferred tax liability not recognized because of the exceptions to comprehensive recognition of deferred taxes related to undistributed earnings of foreign subsidiaries."
"Defined Contribution Plan, Cost"	"Amount of cost for defined contribution plan."
"Defined Contribution Plan, Maximum Annual Contribution Per Employee, Amount (Deprecated 2013-01-31)"	"Maximum amount per employee, by the terms of the plan, that the employer may contribute to a defined contribution plan."
"Defined Contribution Plan, Maximum Annual Contributions Per Employee, Amount"	"Maximum amount the employee may contribute to a defined contribution plan."
"Depreciation"	"The amount of expense recognized in the current period that reflects the allocation of the cost of tangible assets over the assets' useful lives. Includes production and non-production related depreciation."
"Depreciation, Amortization and Accretion, Net"	"The aggregate net amount of depreciation, amortization, and accretion recognized during an accounting period. As a noncash item, the net amount is added back to net income when calculating cash provided by or used in operations using the indirect method."
"Depreciation, Depletion and Amortization, Nonproduction"	"The current period expense charged against earnings on long-lived, physical assets not used in production, and which are not intended for resale, to allocate or recognize the cost of such assets over their useful lives; or to record the reduction in book value of an intangible asset over the benefit period of such asset; or to reflect consumption during the period of an asset that is not used in production."
"Depreciation, Depletion and Amortization"	"The aggregate expense recognized in the current period that allocates the cost of tangible assets, intangible assets, or depleting assets to periods that benefit from use of the assets."
"Derivative, Collateral, Obligation to Return Cash"	"Amount of obligation to return cash collateral under master netting arrangements that have not been offset against derivative assets."
"Derivative, Fair Value, Net"	"Fair value of the assets less the liabilities of a derivative or group of derivatives."
"Derivative Instruments, Gain (Loss) Reclassified from Accumulated OCI into Income, Effective Portion, Net"	"The effective portion of net gain (loss) reclassified from accumulated other comprehensive income into income on derivative instruments designated and qualifying as hedging instruments."
"Derivative Instruments, Gain (Loss) Recognized in Income, Ineffective Portion and Amount Excluded from Effectiveness Testing, Net"	"The portion of gains and losses (net) on derivative instruments designated and qualifying as hedging instruments representing (a) the amount of the hedge ineffectiveness and (b) the amount, if any, excluded from the assessment of hedge effectiveness."
"Derivative Instruments, Gain (Loss) Recognized in Other Comprehensive Income (Loss), Effective Portion, Net (Deprecated 2018-01-31)"	"The effective portion of gains and losses (net) on derivative instruments designated and qualifying as hedging instruments that was recognized in other comprehensive income during the current period."
"Derivative Instruments Not Designated as Hedging Instruments, Gain (Loss), Net"	"Amount of realized and unrealized gain (loss) of derivative instruments not designated or qualifying as hedging instruments."
"Dividends"	"Amount of paid and unpaid cash, stock, and paid-in-kind (PIK) dividends declared, for example, but not limited to, common and preferred stock."
"Earnings Per Share, Basic"	"The amount of net income (loss) for the period per each share of common stock or unit outstanding during the reporting period."
"Earnings Per Share, Diluted"	"The amount of net income (loss) for the period available to each share of common stock or common unit outstanding during the reporting period and to each share or unit that would have been outstanding assuming the issuance of common shares or units for all dilutive potential common shares or units outstanding during the reporting period."
"Effective Income Tax Rate Reconciliation, Percent"	"Percentage of current income tax expense (benefit) and deferred income tax expense (benefit) pertaining to continuing operations."
"Effective Income Tax Rate Reconciliation, at Federal Statutory Income Tax Rate, Percent"	"Percentage of domestic federal statutory tax rate applicable to pretax income (loss)."
"Effective Income Tax Rate Reconciliation, Foreign Income Tax Rate Differential, Percent"	"Percentage of the difference between reported income tax expense (benefit) and expected income tax expense (benefit) computed by applying the domestic federal statutory income tax rates to pretax income (loss) from continuing operations applicable to statutory income tax expense (benefit) outside of the country of domicile."
"Effective Income Tax Rate Reconciliation, Tax Expense (Benefit), Share-based Payment Arrangement, Amount"	"Amount of difference between reported income tax expense (benefit) and expected income tax expense (benefit) computed by applying domestic federal statutory income tax rate to pretax income (loss) from continuing operation, attributable to expense for award under share-based payment arrangement. Excludes expense determined to be nondeductible upon grant or after for award under share-based payment arrangement."
"Effective Income Tax Rate Reconciliation, Tax Cuts and Jobs Act, Amount"	"Amount of reported income tax expense (benefit) in excess of (less than) expected income tax expense (benefit) computed by applying domestic federal statutory income tax rate to pretax income (loss) from continuing operations, attributable to Tax Cuts and Jobs Act."
"Employee-related Liabilities, Current"	"Total of the carrying values as of the balance sheet date of obligations incurred through that date and payable for obligations related to services received from employees, such as accrued salaries and bonuses, payroll taxes and fringe benefits. Used to reflect the current portion of the liabilities (due within one year or within the normal operating cycle if longer)."
"Share-based Payment Arrangement, Cash Used to Settle Award"	"Aggregate cash paid by the entity during the period to settle equity instruments granted under equity-based payment arrangements."
"Share-based Payment Arrangement, Nonvested Award, Cost Not yet Recognized, Amount"	"Amount of cost not yet recognized for nonvested award under share-based payment arrangement."
"Employee Service Share-based Compensation, Nonvested Awards, Total Compensation Cost Not yet Recognized, Period for Recognition (Deprecated 2012-01-31)"	"The weighted average period over which unrecognized compensation is expected to be recognized for equity-based compensation plans, using a decimal to express in number of years."
"Share-based Payment Arrangement, Expense, Tax Benefit"	"Amount of tax benefit for recognition of expense of award under share-based payment arrangement."
"Employee Service Share-based Compensation, Unrecognized Compensation Costs on Nonvested Awards (Deprecated 2011-01-31)"	"As of the latest balance sheet date presented, the total compensation cost related to outstanding, nonvested equity-based compensation awards not yet recognized (will be charged against earnings as services are performed or other vesting criteria are met)."
"Employee Service Share-based Compensation, Unrecognized Compensation Costs on Nonvested Awards, Weighted Average Period of Recognition (Deprecated 2011-01-31)"	"The weighted average period over which unrecognized equity-based compensation costs are expected to be reported."
"Equity Securities without Readily Determinable Fair Value, Amount"	"Amount of investment in equity security without readily determinable fair value."
"Excess Tax Benefit from Share-based Compensation, Financing Activities"	"Amount of cash inflow from realized tax benefit related to deductible compensation cost reported on the entity's tax return for equity instruments in excess of the compensation cost for those instruments recognized for financial reporting purposes."
"Fair Value, Assets Measured on Recurring Basis, Cash and Cash Equivalents (Deprecated 2011-01-31)"	"This element represents a certain statement of financial position asset caption which represents a class of assets, or which may include an individual asset, measured at fair value on a recurring basis."
"Fair Value, Assets Measured on Recurring Basis, Derivative Financial Instruments, Assets (Deprecated 2011-01-31)"	"This element represents a certain statement of financial position asset caption which represents a class of assets, or which may include an individual asset, measured at fair value on a recurring basis."
"Fair Value Hedges, Net"	"Net fair value of all derivative instruments designated as fair value hedging instruments."
"Fair Value, Liabilities Measured on Recurring Basis, Derivative Financial Instruments, Liabilities (Deprecated 2011-01-31)"	"This element represents a certain statement of financial position liability caption which represents a class of liabilities, or which may include an individual liability, measured at fair value on a recurring basis."
"Federal Income Tax Expense (Benefit), Continuing Operations"	"Amount of current and deferred federal income tax expense (benefit) attributable to income (loss) from continuing operations."
"Finance Lease, Liability"	"Present value of lessee's discounted obligation for lease payments from finance lease."
"Finance Lease, Liability, Current"	"Present value of lessee's discounted obligation for lease payments from finance lease, classified as current."
"Finance Lease, Liability, Noncurrent"	"Present value of lessee's discounted obligation for lease payments from finance lease, classified as noncurrent."
"Finance Lease, Liability, Payment, Due"	"Amount of lessee's undiscounted obligation for lease payments for finance lease."
"Finance Lease, Liability, to be Paid, after Year Five"	"Amount of lessee's undiscounted obligation for lease payment for finance lease to be paid after fifth fiscal year following current fiscal year. Excludes interim and annual periods when interim periods are reported from current statement of financial position date (rolling approach)."
"Finance Lease, Liability, to be Paid, Year One"	"Amount of lessee's undiscounted obligation for lease payment for finance lease to be paid in next fiscal year following current fiscal year. Excludes interim and annual periods when interim periods are reported from current statement of financial position date (rolling approach)."
"Finance Lease, Liability, to be Paid, Year Five"	"Amount of lessee's undiscounted obligation for lease payment for finance lease to be paid in fifth fiscal year following current fiscal year. Excludes interim and annual periods when interim periods are reported from current statement of financial position date (rolling approach)."
"Finance Lease, Liability, to be Paid, Year Four"	"Amount of lessee's undiscounted obligation for lease payment for finance lease to be paid in fourth fiscal year following current fiscal year. Excludes interim and annual periods when interim periods are reported from current statement of financial position date (rolling approach)."
"Finance Lease, Liability, to be Paid, Year Three"	"Amount of lessee's undiscounted obligation for lease payment for finance lease to be paid in third fiscal year following current fiscal year. Excludes interim and annual periods when interim periods are reported from current statement of financial position date (rolling approach)."
"Finance Lease, Liability, to be Paid, Year Two"	"Amount of lessee's undiscounted obligation for lease payment for finance lease to be paid in second fiscal year following current fiscal year. Excludes interim and annual periods when interim periods are reported from current statement of financial position date (rolling approach)."
"Finance Lease, Liability, to be Paid, Remainder of Fiscal Year"	"Amount of lessee's undiscounted obligation for lease payment for finance lease to be paid in remainder of current fiscal year."
"Finance Lease, Liability, Undiscounted Excess Amount"	"Amount of lessee's undiscounted obligation for lease payments in excess of discounted obligation for lease payments for finance lease."
"Finance Lease, Right-of-Use Asset, after Accumulated Amortization"	"Amount, after accumulated amortization, of right-of-use asset from finance lease."
"Finite-Lived Intangible Assets, Accumulated Amortization"	"Accumulated amount of amortization of assets, excluding financial assets and goodwill, lacking physical substance with a finite life."
"Finite-Lived Intangible Assets, Amortization Expense (Deprecated 2012-01-31)"	"Aggregate amount of intangible asset amortization recognized as expense during the period."
"Finite-Lived Intangible Asset, Expected Amortization, after Year Five"	"Amount of amortization for asset, excluding financial asset and goodwill, lacking physical substance with finite life expected to be recognized after fifth fiscal year following current fiscal year. Excludes interim and annual periods when interim periods are reported from current statement of financial position date (rolling approach)."
"Finite-Lived Intangible Asset, Expected Amortization, Year One"	"Amount of amortization for assets, excluding financial assets and goodwill, lacking physical substance with finite life expected to be recognized in next fiscal year following current fiscal year. Excludes interim and annual periods when interim periods are reported from current statement of financial position date (rolling approach)."
"Finite-Lived Intangible Asset, Expected Amortization, Year Five"	"Amount of amortization for assets, excluding financial assets and goodwill, lacking physical substance with finite life expected to be recognized in fifth fiscal year following current fiscal year. Excludes interim and annual periods when interim periods are reported from current statement of financial position date (rolling approach)."
"Finite-Lived Intangible Asset, Expected Amortization, Year Four"	"Amount of amortization for assets, excluding financial assets and goodwill, lacking physical substance with finite life expected to be recognized in fourth fiscal year following current fiscal year. Excludes interim and annual periods when interim periods are reported from current statement of financial position date (rolling approach)."
"Finite-Lived Intangible Asset, Expected Amortization, Year Three"	"Amount of amortization for assets, excluding financial assets and goodwill, lacking physical substance with finite life expected to be recognized in third fiscal year following current fiscal year. Excludes interim and annual periods when interim periods are reported from current statement of financial position date (rolling approach)."
"Finite-Lived Intangible Asset, Expected Amortization, Year Two"	"Amount of amortization for assets, excluding financial assets and goodwill, lacking physical substance with finite life expected to be recognized in second fiscal year following current fiscal year. Excludes interim and annual periods when interim periods are reported from current statement of financial position date (rolling approach)."
"Finite-Lived Intangible Assets, Gross"	"Amount before amortization of assets, excluding financial assets and goodwill, lacking physical substance with a finite life."
"Finite-Lived Intangible Assets, Net"	"Amount after amortization of assets, excluding financial assets and goodwill, lacking physical substance with a finite life."
"Finite-Lived Intangible Assets, Useful Life, Maximum (Deprecated 2012-01-31)"	"The maximum useful life of a major finite-lived intangible asset class. A major class is composed of intangible assets that can be grouped together because they are similar either by their nature or by their use in the operations of a company."
"Finite-Lived Intangible Assets, Useful Life, Minimum (Deprecated 2012-01-31)"	"The minimum useful life of a major finite-lived intangible asset class. A major class is composed of intangible assets that can be grouped together because they are similar either by their nature or by their use in the operations of a company."
"Foreign Currency Derivative Assets at Fair Value (Deprecated 2014-01-31)"	"Fair value as of the balance sheet date of foreign currency derivative assets, which includes all such derivative instruments in hedging and nonhedging relationships that are recognized as assets on the balance sheet."
"Foreign Currency Derivative Instruments Not Designated as Hedging Instruments, Asset at Fair Value"	"Fair value as of the balance sheet date of all foreign currency derivative assets not designated as hedging instruments."
"Foreign Currency Derivative Instruments Not Designated as Hedging Instruments, Liability at Fair Value"	"Fair value as of the balance sheet date of all foreign currency derivative liabilities not designated as hedging instruments."
"Foreign Currency Derivative Liabilities at Fair Value (Deprecated 2014-01-31)"	"Fair value as of the balance sheet date of interest rate derivative liabilities, which includes all such derivative instruments in hedging and nonhedging relationships that are recognized as liabilities on the balance sheet."
"Foreign Income Tax Expense (Benefit), Continuing Operations"	"Amount of current and deferred foreign income tax expense (benefit) attributable to income (loss) from continuing operations."
"Furniture and Fixtures, Gross"	"Amount before accumulated depreciation of equipment commonly used in offices and stores that have no permanent connection to the structure of a building or utilities. Examples include, but are not limited to, desks, chairs, tables, and bookcases."
"Future Amortization Expense, Year Five (Deprecated 2012-01-31)"	"The amount of amortization expense expected to be recognized during year five of the five succeeding fiscal years."
"Future Amortization Expense, Year Four (Deprecated 2012-01-31)"	"The amount of amortization expense expected to be recognized during year four of the five succeeding fiscal years."
"Future Amortization Expense, Year One (Deprecated 2012-01-31)"	"The amount of amortization expense expected to be recognized during year one of the five succeeding fiscal years."
"Future Amortization Expense, Year Three (Deprecated 2012-01-31)"	"The amount of amortization expense expected to be recognized during year three of the five succeeding fiscal years."
"Future Amortization Expense, Year Two (Deprecated 2012-01-31)"	"The amount of amortization expense expected to be recognized during year two of the five succeeding fiscal years."
"Gain (Loss) from Components Excluded from Assessment of Fair Value Hedge Effectiveness, Net"	"Net gain (loss) relating to components of the gain (loss) on the fair value hedging instrument excluded from the assessment of fair value hedge effectiveness. Recognized in earnings."
"Gain (Loss) on Disposition of Property Plant Equipment"	"Amount of gain (loss) on sale or disposal of property, plant and equipment assets, including oil and gas property and timber property."
"Goodwill"	"Amount after accumulated impairment loss of an asset representing future economic benefits arising from other assets acquired in a business combination that are not individually identified and separately recognized."
"Goodwill, Acquired During Period"	"Amount of increase in asset representing future economic benefits arising from other assets acquired in a business combination that are not individually identified and separately recognized resulting from a business combination."
"Goodwill, Impairment Loss"	"Amount of loss from the write-down of an asset representing the future economic benefits arising from other assets acquired in a business combination that are not individually identified and separately recognized."
"Gross Profit"	"Aggregate revenue less cost of goods and services sold or operating expenses directly attributable to the revenue generation activity."
"Debt Securities, Held-to-maturity"	"Amount of investment in debt security measured at amortized cost (held-to-maturity)."
"Impairment of Intangible Assets (Excluding Goodwill)"	"The amount of impairment loss recognized in the period resulting from the write-down of the carrying amount of an intangible asset (excluding goodwill) to fair value."
"Impairment of Intangible Assets, Indefinite-lived (Excluding Goodwill)"	"Amount of impairment loss resulting from write-down of assets, excluding financial assets and goodwill, lacking physical substance and having a projected indefinite period of benefit to fair value."
"Income (Loss) from Continuing Operations before Income Taxes, Noncontrolling Interest"	"Amount of income (loss) from continuing operations, including income (loss) from equity method investments, before deduction of income tax expense (benefit), and income (loss) attributable to noncontrolling interest."
"Income (Loss) from Continuing Operations before Income Taxes, Foreign"	"The portion of earnings or loss from continuing operations before income taxes that is attributable to foreign operations, which is defined as Income or Loss generated from operations located outside the entity's country of domicile."
"Income (Loss) from Continuing Operations before Equity Method Investments, Income Taxes, Noncontrolling Interest"	"Amount of income (loss) from continuing operations before deduction of income tax expense (benefit) and income (loss) attributable to noncontrolling interest, and addition of income (loss) from equity method investments."
"Income Tax Examination, Interest Expense"	"The amount of estimated interest recognized in the period arising from income tax examinations."
"Income Tax Expense (Benefit)"	"Amount of current income tax expense (benefit) and deferred income tax expense (benefit) pertaining to continuing operations."
"Income Taxes Paid, Net"	"The amount of cash paid during the current period to foreign, federal, state, and local authorities as taxes on income, net of any cash received during the current period as refunds for the overpayment of taxes."
"Effective Income Tax Rate Reconciliation, Deduction, Qualified Production Activity, Amount"	"Amount of the difference between reported income tax expense (benefit) and the expected income tax expense (benefit) computed by applying the domestic federal statutory income tax rates to pretax income (loss) from continuing operations attributable to deduction for qualified production activity."
"Effective Income Tax Rate Reconciliation, Foreign Income Tax Rate Differential, Amount"	"Amount of the difference between reported income tax expense (benefit) and expected income tax expense (benefit) computed by applying the domestic federal statutory income tax rates to pretax income (loss) from continuing operations attributable to foreign income tax expense (benefit)."
"Effective Income Tax Rate Reconciliation at Federal Statutory Income Tax Rate, Amount"	"The amount of income tax expense or benefit for the period computed by applying the domestic federal statutory tax rates to pretax income from continuing operations."
"Effective Income Tax Rate Reconciliation, Nondeductible Expense, Share-based Payment Arrangement, Amount"	"Amount of reported income tax expense (benefit) in excess of (less than) expected income tax expense (benefit) computed by applying domestic federal statutory income tax rate to pretax income (loss) from continuing operation, attributable to nondeductible expense for award under share-based payment arrangement. Includes, but is not limited to, expense determined to be nondeductible upon grant or after for award under share-based payment arrangement."
"Effective Income Tax Rate Reconciliation, Other Adjustments, Amount"	"Amount of the difference between reported income tax expense (benefit) and expected income tax expense (benefit) computed by applying the domestic federal statutory income tax rates to pretax income (loss) from continuing operations attributable to other adjustments."
"Effective Income Tax Rate Reconciliation, Other Reconciling Items, Amount"	"Amount of the difference between reported income tax expense (benefit) and expected income tax expense (benefit) computed by applying the domestic federal statutory income tax rates to pretax income (loss) from continuing operations attributable to tax exempt income, equity in earnings (loss) of an unconsolidated subsidiary, minority noncontrolling interest income (loss), tax holiday, disposition of a business, disposition of an asset, repatriation of foreign earnings, repatriation of foreign earnings jobs creation act of 2004, increase (decrease) in enacted tax rate, prior year income taxes, increase (decrease) in deferred tax asset valuation allowance, and other adjustments."
"Effective Income Tax Rate Reconciliation, State and Local Income Taxes, Amount"	"Amount of the difference between reported income tax expense (benefit) and expected income tax expense (benefit) computed by applying the domestic federal statutory income tax rates to pretax income (loss) from continuing operations attributable to state and local income tax expense (benefit)."
"Effective Income Tax Rate Reconciliation, Tax Contingency, Domestic, Amount"	"Amount of the difference between reported income tax expense (benefit) and expected income tax expense (benefit) computed by applying the domestic federal statutory income tax rates to pretax income (loss) from continuing operations attributable to increase (decrease) in domestic income tax contingency."
"Effective Income Tax Rate Reconciliation, Tax Credit, Research, Amount"	"Amount of the difference between reported income tax expense (benefit) and expected income tax expense (benefit) computed by applying the domestic federal statutory income tax rates to pretax income (loss) from continuing operations attributable to research tax credit."
"Effective Income Tax Rate Reconciliation, Tax Settlement, Domestic, Amount"	"Amount of the difference between reported income tax expense (benefit) and expected income tax expense (benefit) computed by applying the domestic federal statutory income tax rates to pretax income (loss) from continuing operations attributable to domestic income tax settlement."
"Increase (Decrease) in Accounts Payable"	"The increase (decrease) during the reporting period in the aggregate amount of liabilities incurred (and for which invoices have typically been received) and payable to vendors for goods and services received that are used in an entity's business."
"Increase (Decrease) in Accounts Receivable"	"The increase (decrease) during the reporting period in amount due within one year (or one business cycle) from customers for the credit sale of goods and services."
"Increase (Decrease) in Contract with Customer, Liability"	"Amount of increase (decrease) in obligation to transfer good or service to customer for which consideration has been received or is receivable."
"Increase (Decrease) in Deferred Revenue"	"Amount of increase (decrease) in deferred income and obligation to transfer product and service to customer for which consideration has been received or is receivable."
"Increase (Decrease) in Inventories"	"The increase (decrease) during the reporting period in the aggregate value of all inventory held by the reporting entity, associated with underlying transactions that are classified as operating activities."
"Increase (Decrease) in Other Operating Assets"	"Amount of increase (decrease) in operating assets classified as other."
"Increase (Decrease) in Other Operating Liabilities"	"Amount of increase (decrease) in operating liabilities classified as other."
"Increase (Decrease) in Other Receivables"	"Amount of increase (decrease) in receivables classified as other."
"Indefinite-lived Intangible Assets (Excluding Goodwill)"	"Amount of assets, excluding financial assets and goodwill, lacking physical substance and having a projected indefinite period of benefit."
"Intangible Assets, Gross (Excluding Goodwill)"	"Amount before accumulated amortization of intangible assets, excluding goodwill."
"Intangible Assets, Net (Excluding Goodwill)"	"Sum of the carrying amounts of all intangible assets, excluding goodwill, as of the balance sheet date, net of accumulated amortization and impairment charges."
"Interest Costs Incurred"	"Total interest costs incurred during the period and either capitalized or charged against earnings."
"Interest Expense"	"Amount of the cost of borrowed funds accounted for as interest expense."
"Interest Expense, Debt"	"Amount of the cost of borrowed funds accounted for as interest expense for debt."
"Interest Paid, Including Capitalized Interest, Operating and Investing Activities"	"Amount of cash paid for interest, including, but not limited to, capitalized interest and payment to settle zero-coupon bond attributable to accreted interest of debt discount and debt instrument with insignificant coupon interest rate in relation to effective interest rate of borrowing attributable to accreted interest of debt discount; classified as operating and investing activities."
"Interest Paid, Excluding Capitalized Interest, Operating Activities"	"Amount of cash paid for interest, excluding capitalized interest, classified as operating activity. Includes, but is not limited to, payment to settle zero-coupon bond for accreted interest of debt discount and debt instrument with insignificant coupon interest rate in relation to effective interest rate of borrowing attributable to accreted interest of debt discount."
"Inventory, Finished Goods, Net of Reserves"	"Carrying amount, net of valuation reserves and adjustments, as of the balance sheet date of merchandise or goods held by the company that are readily available for sale."
"Inventory, Net"	"Amount after valuation and LIFO reserves of inventory expected to be sold, or consumed within one year or operating cycle, if longer."
"Inventory, Parts and Components, Net of Reserves"	"Carrying amount, net of valuation reserves and adjustments, as of the balance sheet date for elements of machinery or equipment held for the purpose of replacing similar parts in the course of repair or maintenance."
"Investment Income, Interest and Dividend"	"Amount before accretion (amortization) of purchase discount (premium) of interest income and dividend income on nonoperating securities."
"Operating Leases, Rent Expense"	"Amount of rent expense incurred for leased assets, including but not limited to, furniture and equipment, that is not directly or indirectly associated with the manufacture, sale or creation of a product or product line."
"Leasehold Improvements, Gross"	"Amount before accumulated depreciation of additions or improvements to assets held under a lease arrangement."
"Lessee, Operating Lease, Liability, to be Paid"	"Amount of lessee's undiscounted obligation for lease payment for operating lease."
"Lessee, Operating Lease, Liability, to be Paid, after Year Five"	"Amount of lessee's undiscounted obligation for lease payment for operating lease due after fifth fiscal year following current fiscal year. Excludes interim and annual periods when interim periods are reported from current statement of financial position date (rolling approach)."
"Lessee, Operating Lease, Liability, to be Paid, Year One"	"Amount of lessee's undiscounted obligation for lease payment for operating lease to be paid in next fiscal year following current fiscal year. Excludes interim and annual periods when interim periods are reported from current statement of financial position date (rolling approach)."
"Lessee, Operating Lease, Liability, to be Paid, Year Five"	"Amount of lessee's undiscounted obligation for lease payment for operating lease to be paid in fifth fiscal year following current fiscal year. Excludes interim and annual periods when interim periods are reported from current statement of financial position date (rolling approach)."
"Lessee, Operating Lease, Liability, to be Paid, Year Four"	"Amount of lessee's undiscounted obligation for lease payment for operating lease to be paid in fourth fiscal year following current fiscal year. Excludes interim and annual periods when interim periods are reported from current statement of financial position date (rolling approach)."
"Lessee, Operating Lease, Liability, to be Paid, Year Three"	"Amount of lessee's undiscounted obligation for lease payment for operating lease to be paid in third fiscal year following current fiscal year. Excludes interim and annual periods when interim periods are reported from current statement of financial position date (rolling approach)."
"Lessee, Operating Lease, Liability, to be Paid, Year Two"	"Amount of lessee's undiscounted obligation for lease payment for operating lease to be paid in second fiscal year following current fiscal year. Excludes interim and annual periods when interim periods are reported from current statement of financial position date (rolling approach)."
"Lessee, Operating Lease, Liability, to be Paid, Remainder of Fiscal Year"	"Amount of lessee's undiscounted obligation for lease payment for operating lease having initial or remaining lease term in excess of one year to be paid in remainder of current fiscal year."
"Lessee, Operating Lease, Liability, Undiscounted Excess Amount"	"Amount of lessee's undiscounted obligation for lease payments in excess of discounted obligation for lease payments for operating lease."
"Liabilities"	"Sum of the carrying amounts as of the balance sheet date of all liabilities that are recognized. Liabilities are probable future sacrifices of economic benefits arising from present obligations of an entity to transfer assets or provide services to other entities in the future."
"Liabilities and Equity"	"Amount of liabilities and equity items, including the portion of equity attributable to noncontrolling interests, if any."
"Liabilities, Current"	"Total obligations incurred as part of normal operations that are expected to be paid during the following twelve months or within one business cycle, if longer."
"Liabilities, Noncurrent"	"Amount of obligation due after one year or beyond the normal operating cycle, if longer."
"Long-term Debt"	"Amount, after unamortized (discount) premium and debt issuance costs, of long-term debt. Includes, but not limited to, notes payable, bonds payable, debentures, mortgage loans and commercial paper. Excludes capital lease obligations."
"Long-term Debt, Current Maturities"	"Amount, after unamortized (discount) premium and debt issuance costs, of long-term debt, classified as current. Includes, but not limited to, notes payable, bonds payable, debentures, mortgage loans and commercial paper. Excludes capital lease obligations."
"Long-Term Debt, Maturity, after Year Five"	"Amount of long-term debt payable, sinking fund requirement, and other securities issued that are redeemable by holder at fixed or determinable price and date, maturing after fifth fiscal year following current fiscal year. Excludes interim and annual periods when interim periods are reported from current statement of financial position date (rolling approach)."
"Long-Term Debt, Maturity, Year One"	"Amount of long-term debt payable, sinking fund requirement, and other securities issued that are redeemable by holder at fixed or determinable price and date, maturing in next fiscal year following current fiscal year. Excludes interim and annual periods when interim periods are reported from current statement of financial position date (rolling approach)."
"Long-Term Debt, Maturity, Year Five"	"Amount of long-term debt payable, sinking fund requirement, and other securities issued that are redeemable by holder at fixed or determinable price and date, maturing in fifth fiscal year following current fiscal year. Excludes interim and annual periods when interim periods are reported from current statement of financial position date (rolling approach)."
"Long-Term Debt, Maturity, Year Four"	"Amount of long-term debt payable, sinking fund requirement, and other securities issued that are redeemable by holder at fixed or determinable price and date, maturing in fourth fiscal year following current fiscal year. Excludes interim and annual periods when interim periods are reported from current statement of financial position date (rolling approach)."
"Long-Term Debt, Maturity, Year Three"	"Amount of long-term debt payable, sinking fund requirement, and other securities issued that are redeemable by holder at fixed or determinable price and date, maturing in third fiscal year following current fiscal year. Excludes interim and annual periods when interim periods are reported from current statement of financial position date (rolling approach)."
"Long-Term Debt, Maturity, Year Two"	"Amount of long-term debt payable, sinking fund requirement, and other securities issued that are redeemable by holder at fixed or determinable price and date, maturing in second fiscal year following current fiscal year. Excludes interim and annual periods when interim periods are reported from current statement of financial position date (rolling approach)."
"Long-Term Debt, Maturity, Remainder of Fiscal Year"	"Amount of long-term debt payable, sinking fund requirement, and other securities issued that are redeemable by holder at fixed or determinable price and date, maturing in remainder of current fiscal year."
"Long-term Debt, Excluding Current Maturities"	"Amount after unamortized (discount) premium and debt issuance costs of long-term debt classified as noncurrent and excluding amounts to be repaid within one year or the normal operating cycle, if longer. Includes, but not limited to, notes payable, bonds payable, debentures, mortgage loans and commercial paper. Excludes capital lease obligations."
"Long-term Purchase Commitment, Amount"	"The minimum amount the entity agreed to spend under the long-term purchase commitment."
"Marketable Securities, Current"	"Amount of investment in marketable security, classified as current."
"Marketable Securities, Noncurrent"	"Amount of investment in marketable security, classified as noncurrent."
"Marketable Securities, Realized Gain (Loss)"	"Amount of realized gain (loss) on investment in marketable security, including other-than-temporary impairment (OTTI)."
"Marketing Expense"	"Expenditures for planning and executing the conception, pricing, promotion, and distribution of ideas, goods, and services. Costs of public relations and corporate promotions are typically considered to be marketing costs."
"Net Cash Provided by (Used in) Financing Activities"	"Amount of cash inflow (outflow) from financing activities, including discontinued operations. Financing activity cash flows include obtaining resources from owners and providing them with a return on, and a return of, their investment; borrowing money and repaying amounts borrowed, or settling the obligation; and obtaining and paying for other resources obtained from creditors on long-term credit."
"Net Cash Provided by (Used in) Financing Activities, Continuing Operations"	"Amount of cash inflow (outflow) of financing activities, excluding discontinued operations. Financing activity cash flows include obtaining resources from owners and providing them with a return on, and a return of, their investment; borrowing money and repaying amounts borrowed, or settling the obligation; and obtaining and paying for other resources obtained from creditors on long-term credit."
"Net Cash Provided by (Used in) Investing Activities"	"Amount of cash inflow (outflow) from investing activities, including discontinued operations. Investing activity cash flows include making and collecting loans and acquiring and disposing of debt or equity instruments and property, plant, and equipment and other productive assets."
"Net Cash Provided by (Used in) Investing Activities, Continuing Operations"	"Amount of cash inflow (outflow) of investing activities, excluding discontinued operations. Investing activity cash flows include making and collecting loans and acquiring and disposing of debt or equity instruments and property, plant, and equipment and other productive assets."
"Net Cash Provided by (Used in) Operating Activities"	"Amount of cash inflow (outflow) from operating activities, including discontinued operations. Operating activity cash flows include transactions, adjustments, and changes in value not defined as investing or financing activities."
"Net Cash Provided by (Used in) Operating Activities, Continuing Operations"	"Amount of cash inflow (outflow) from operating activities, excluding discontinued operations. Operating activity cash flows include transactions, adjustments, and changes in value not defined as investing or financing activities."
"Net Income (Loss) Attributable to Parent"	"The portion of profit or loss for the period, net of income taxes, which is attributable to the parent."
"Long-Lived Assets"	"Long-lived assets other than financial instruments, long-term customer relationships of a financial institution, mortgage and other servicing rights, deferred policy acquisition costs, and deferred tax assets."
"Nonoperating Income (Expense)"	"The aggregate amount of income or expense from ancillary business-related activities (that is to say, excluding major activities considered part of the normal operations of the business)."
"Nontrade Receivables, Current"	"The sum of amounts currently receivable other than from customers. For classified balance sheets, represents the current amount receivable, that is amounts expected to be collected within one year or the normal operating cycle, if longer."
"Notional Amount of Foreign Currency Derivative Instruments Not Designated as Hedging Instruments (Deprecated 2013-01-31)"	"Aggregate notional amount of all foreign currency derivatives not designated as hedging instruments. Notional amount refers to the number of currency units specified in the foreign currency derivative contract."
"Number of Stores"	"Represents the number of stores."
"OCI, before Reclassifications, before Tax, Attributable to Parent"	"Amount before tax and reclassification adjustments of other comprehensive income (loss) attributable to parent."
"Operating Expenses"	"Generally recurring costs associated with normal operations except for the portion of these expenses which can be clearly related to production and included in cost of sales or services. Includes selling, general and administrative expense."
"Operating Income (Loss)"	"The net result for the period of deducting operating expenses from operating revenues."
"Operating Lease, Cost"	"Amount of single lease cost, calculated by allocation of remaining cost of lease over remaining lease term. Includes, but is not limited to, single lease cost, after impairment of right-of-use asset, calculated by amortization of remaining right-of-use asset and accretion of lease liability."
"Operating Lease, Liability"	"Present value of lessee's discounted obligation for lease payments from operating lease."
"Operating Lease, Liability, Current"	"Present value of lessee's discounted obligation for lease payments from operating lease, classified as current."
"Operating Lease, Liability, Noncurrent"	"Present value of lessee's discounted obligation for lease payments from operating lease, classified as noncurrent."
"Operating Lease, Payments"	"Amount of cash outflow from operating lease, excluding payments to bring another asset to condition and location necessary for its intended use."
"Operating Lease, Right-of-Use Asset"	"Amount of lessee's right to use underlying asset under operating lease."
"Operating Leases, Future Minimum Payments Due"	"Amount of required minimum rental payments for leases having an initial or remaining non-cancelable letter-terms in excess of one year."
"Operating Leases, Future Minimum Payments Due, Next Twelve Months"	"Amount of required minimum rental payments for operating leases having an initial or remaining non-cancelable lease term in excess of one year due in the next fiscal year following the latest fiscal year. Excludes interim and annual periods when interim periods are reported on a rolling approach, from latest balance sheet date."
"Operating Leases, Future Minimum Payments, Due in Five Years"	"Amount of required minimum rental payments for operating leases having an initial or remaining non-cancelable lease term in excess of one year due in the fifth fiscal year following the latest fiscal year. Excludes interim and annual periods when interim periods are reported on a rolling approach, from latest balance sheet date."
"Operating Leases, Future Minimum Payments, Due in Four Years"	"Amount of required minimum rental payments for operating leases having an initial or remaining non-cancelable lease term in excess of one year due in the fourth fiscal year following the latest fiscal year. Excludes interim and annual periods when interim periods are reported on a rolling approach, from latest balance sheet date."
"Operating Leases, Future Minimum Payments, Due in Three Years"	"Amount of required minimum rental payments for operating leases having an initial or remaining non-cancelable lease term in excess of one year due in the third fiscal year following the latest fiscal year. Excludes interim and annual periods when interim periods are reported on a rolling approach, from latest balance sheet date."
"Operating Leases, Future Minimum Payments, Due in Two Years"	"Amount of required minimum rental payments for operating leases having an initial or remaining non-cancelable lease term in excess of one year due in the second fiscal year following the latest fiscal year. Excludes interim and annual periods when interim periods are reported on a rolling approach, from latest balance sheet date."
"Operating Leases, Future Minimum Payments, Due Thereafter"	"Amount of required minimum rental payments for operating leases having an initial or remaining non-cancelable lease term in excess of one year due after the fifth fiscal year following the latest fiscal year. Excludes interim and annual periods when interim periods are reported on a rolling approach, from latest balance sheet date."
"Operating Leases, Rent Expense, Net"	"Rental expense for the reporting period incurred under operating leases, including minimum and any contingent rent expense, net of related sublease income."
"Other Accrued Liabilities, Current"	"Amount of expenses incurred but not yet paid classified as other, due within one year or the normal operating cycle, if longer."
"Other Accrued Liabilities, Noncurrent"	"Amount of expenses incurred but not yet paid classified as other, due after one year or the normal operating cycle, if longer."
"Other Assets, Current"	"Amount of current assets classified as other."
"Other Assets, Noncurrent"	"Amount of noncurrent assets classified as other."
"Other Comprehensive Income (Loss), Available-for-sale Securities Adjustment, Net of Tax (Deprecated 2012-01-31)"	"Gross appreciation or the gross loss in value of the total unsold securities. While for technical reasons this element has no balance attribute, the default assumption is a credit balance consistent with its label."
"Other Comprehensive Income (Loss), Derivatives Qualifying as Hedges, Net of Tax (Deprecated 2012-01-31)"	"Net of tax effect change in accumulated gains and losses from derivative instruments designated and qualifying as the effective portion of cash flow hedges after taxes. A cash flow hedge is a hedge of the exposure to variability in the cash flows of a recognized asset or liability or a forecasted transaction that is attributable to a particular risk. The change includes an entity's share of an equity investee's increase or decrease in deferred hedging gains or losses. While for technical reasons this element has no balance attribute, the default assumption is a credit balance consistent with its label."
"Other Comprehensive Income (Loss), Foreign Currency Transaction and Translation Adjustment, Net of Tax (Deprecated 2012-01-31)"	"Adjustment that results from the process of translating subsidiary financial statements and foreign equity investments into the reporting currency of the reporting entity, net of tax."
"OCI, Debt Securities, Available-for-Sale, Gain (Loss), after Adjustment and Tax"	"Amount, after tax and adjustment, of unrealized gain (loss) on investment in debt security measured at fair value with change in fair value recognized in other comprehensive income (available-for-sale) and unrealized gain (loss) on investment in debt security measured at amortized cost (held-to-maturity) from transfer to available-for-sale."
"Other Comprehensive Income (Loss), before Reclassifications, before Tax"	"Amount before tax and reclassification adjustments of other comprehensive income (loss)."
"Other Comprehensive Income (Loss), before Reclassifications, Net of Tax"	"Amount after tax, before reclassification adjustments of other comprehensive income (loss)."
"Other Comprehensive Income (Loss), Cash Flow Hedge, Gain (Loss), before Reclassification and Tax"	"Amount, before tax and reclassification, of gain (loss) from derivative instrument designated and qualifying cash flow hedge included in assessment of hedge effectiveness."
"Other Comprehensive Income (Loss), Cash Flow Hedge, Gain (Loss), Reclassification, after Tax"	"Amount, after tax, of reclassification of gain (loss) from accumulated other comprehensive income (AOCI) for derivative instrument designated and qualifying as cash flow hedge included in assessment of hedge effectiveness."
"Other Comprehensive Income (Loss), Cash Flow Hedge, Gain (Loss), Reclassification, before Tax"	"Amount, before tax, of reclassification of gain (loss) from accumulated other comprehensive income (AOCI) for derivative instrument designated and qualifying as cash flow hedge included in assessment of hedge effectiveness."
"Other Comprehensive Income (Loss), Derivative, Excluded Component, Increase (Decrease), before Adjustments and Tax"	"Amount, before tax and adjustments, of gain (loss) from increase (decrease) in value of excluded component of derivative designated and qualifying as hedge. Adjustments include, but are not limited to, reclassifications for sale and settlement, and amounts recognized under systematic and rational method."
"Other Comprehensive Income (Loss), Derivatives Qualifying as Hedges, Net of Tax"	"Amount after tax and reclassification adjustments, of increase (decrease) in accumulated gain (loss) from derivative instruments designated and qualifying as the effective portion of cash flow hedges and an entity's share of an equity investee's increase (decrease) in deferred hedging gain (loss)."
"Other Comprehensive Income (Loss), Foreign Currency Transaction and Translation Adjustment, Net of Tax"	"Amount after tax and reclassification adjustments of gain (loss) on foreign currency translation adjustments, foreign currency transactions designated and effective as economic hedges of a net investment in a foreign entity and intra-entity foreign currency transactions that are of a long-term-investment nature."
"Other Comprehensive Income (Loss), Foreign Currency Translation Adjustment, Tax"	"Amount of tax expense (benefit), after reclassification adjustments of gain (loss) on foreign currency translation adjustments, foreign currency transactions designated and effective as economic hedges of a net investment in a foreign entity and intra-entity foreign currency transactions that are of a long-term-investment nature."
"Other Comprehensive Income (Loss), Net of Tax"	"Amount after tax and reclassification adjustments of other comprehensive income (loss)."
"Other Comprehensive Income (Loss), Net of Tax, Portion Attributable to Parent"	"Amount after tax of other comprehensive income (loss) attributable to parent entity."
"Other Comprehensive Income (Loss), Reclassification Adjustment for Sale of Securities Included in Net Income, Net of Tax (Deprecated 2013-01-31)"	"Net of tax amount of the income statement impact of the reclassification adjustment for unrealized gain (loss) realized upon the sale of available-for-sale securities."
"Other Comprehensive Income (Loss), Reclassification Adjustment from AOCI for Sale of Securities, before Tax"	"Amount before tax of reclassification adjustment from accumulated other comprehensive income for unrealized gain (loss) realized upon the sale of available-for-sale securities."
"Other Comprehensive Income (Loss), Reclassification Adjustment from AOCI for Sale of Securities, Net of Tax"	"Amount after tax of reclassification adjustment from accumulated other comprehensive income for unrealized gain (loss) realized upon the sale of available-for-sale securities."
"Other Comprehensive Income (Loss), Reclassification Adjustment from AOCI for Sale of Securities, Tax"	"Amount of tax expense (benefit) of reclassification adjustment from accumulated other comprehensive income for unrealized gain (loss) realized upon the sale of available-for-sale securities."
"Other Comprehensive Income (Loss), Reclassification Adjustment from AOCI on Derivatives, before Tax"	"Amount before tax of reclassification adjustment from accumulated other comprehensive income of accumulated gain (loss) realized from derivative instruments designated and qualifying as the effective portion of cash flow hedges and an entity's share of an equity investee's deferred hedging gain (loss)."
"Other Comprehensive Income (Loss), Reclassification Adjustment from AOCI on Derivatives, Net of Tax"	"Amount after tax of reclassification adjustment from accumulated other comprehensive income of accumulated gain (loss) realized from derivative instruments designated and qualifying as the effective portion of cash flow hedges and an entity's share of an equity investee's deferred hedging gain (loss)."
"Other Comprehensive Income (Loss), Reclassification Adjustment from AOCI on Derivatives, Tax"	"Amount of tax expense (benefit) of reclassification adjustment from accumulated other comprehensive income of accumulated gain (loss) realized from derivative instruments designated and qualifying as the effective portion of cash flow hedges and an entity's share of an equity investee's deferred hedging gain (loss)."
"Other Comprehensive Income (Loss), Reclassification Adjustment on Derivatives Included in Net Income, Net of Tax (Deprecated 2013-01-31)"	"Net of tax amount of the income statement impact of the reclassification adjustment of accumulated gain (loss) from derivative instruments designated and qualifying as the effective portion of cash flow hedges realized in net income. Also includes reclassification adjustments of an entity's share of an equity investee's deferred hedging gain (loss) realized in net income."
"Other Comprehensive Income (Loss), Reclassification Adjustment on Derivatives Included in Net Income, Tax (Deprecated 2013-01-31)"	"Tax effect of the income statement impact of the reclassification adjustment of accumulated gain (loss) from derivative instruments designated and qualifying as the effective portion of cash flow hedges realized in net income. Also includes reclassification adjustments of an entity's share of an equity investee's deferred hedging gain (loss) realized in net income."
"Other Comprehensive Income (Loss), Tax"	"Amount of tax expense (benefit) allocated to other comprehensive income (loss)."
"Other Comprehensive Income (Loss), Tax, Portion Attributable to Parent"	"Amount of tax expense (benefit) allocated to other comprehensive income (loss) attributable to parent entity."
"Other Comprehensive Income (Loss), Reclassification Adjustment on Derivatives Included in Net Income, Net of Tax (Deprecated 2012-01-31)"	"Net of tax effect of the reclassification adjustment for accumulated gains and losses from derivative instrument designated and qualifying as the effective portion of cash flow hedges included in accumulated comprehensive income that was realized in net income during the period."
"Other Comprehensive Income (Loss), Reclassification Adjustment on Derivatives Included in Net Income, Tax (Deprecated 2012-01-31)"	"Tax effect on reclassification adjustment for accumulated gains and losses from derivative instrument designated and qualifying as the effective portion of cash flow hedges included in accumulated comprehensive income that was realized in net income during the period."
"Other Comprehensive Income (Loss), Unrealized Gain (Loss) on Derivatives Arising During Period, Net of Tax"	"Amount after tax of increase (decrease) in accumulated gain (loss) from derivative instruments designated and qualifying as the effective portion of cash flow hedges and an entity's share of an equity investee's increase (decrease) in deferred hedging gain (loss)."
"Other Comprehensive Income (Loss), Unrealized Gain (Loss) on Derivatives Arising During Period, Tax"	"Amount of tax expense (benefit), before reclassification adjustments, related to increase (decrease) in accumulated gain (loss) from derivative instruments designated and qualifying as the effective portion of cash flow hedges and an entity's share of an equity investee's increase (decrease) in deferred hedging gain (loss)."
"OCI, Debt Securities, Available-for-Sale, Unrealized Holding Gain (Loss), before Adjustment, after Tax"	"Amount, after tax and before adjustment, of unrealized holding gain (loss) on investment in debt security measured at fair value with change in fair value recognized in other comprehensive income (available-for-sale). Excludes unrealized gain (loss) on investment in debt security measured at amortized cost (held-to-maturity) from transfer to available-for-sale."
"OCI, Debt Securities, Available-for-Sale, Unrealized Holding Gain (Loss), before Adjustment, Tax"	"Amount, before adjustment, of tax expense (benefit) for unrealized holding gain (loss) on investment in debt security measured at fair value with change in fair value recognized in other comprehensive income (available-for-sale). Excludes tax expense (benefit) for unrealized gain (loss) on investment in debt security measured at amortized cost (held-to-maturity) from transfer to available-for-sale."
"Other Deferred Credits, Current"	"Amount of unearned revenue or income classified as other, expected to be taken into income within one year or the normal operating cycle, if longer."
"Other Liabilities, Current"	"Amount of liabilities classified as other, due within one year or the normal operating cycle, if longer."
"Other Liabilities, Noncurrent"	"Amount of liabilities classified as other, due after one year or the normal operating cycle, if longer."
"Other Noncash Income (Expense)"	"Amount of income (expense) included in net income that results in no cash inflow (outflow), classified as other."
"Other Nonoperating Income (Expense)"	"Amount of income (expense) related to nonoperating activities, classified as other."
"Other Prepaid Expense, Current"	"Amount of asset related to consideration paid in advance for other costs that provide economic benefits within a future period of one year or the normal operating cycle, if longer."
"Other Short-term Borrowings"	"Amount of borrowings classified as other, maturing within one year or the normal operating cycle, if longer."
"Payments for (Proceeds from) Other Investing Activities"	"Amount of cash (inflow) outflow from investing activities classified as other."
"Payments for Repurchase of Common Stock"	"The cash outflow to reacquire common stock during the period."
"Payments of Dividends"	"Cash outflow in the form of capital distributions and dividends to common shareholders, preferred shareholders and noncontrolling interests."
"Payments of Ordinary Dividends, Common Stock"	"Amount of cash outflow in the form of ordinary dividends to common shareholders of the parent entity."
"Payment, Tax Withholding, Share-based Payment Arrangement"	"Amount of cash outflow to satisfy grantee's tax withholding obligation for award under share-based payment arrangement."
"Payments to Acquire Available-for-sale Securities"	"The cash outflow to acquire debt and equity securities not classified as either held-to-maturity securities or trading securities which would be classified as available-for-sale securities and reported at fair value, with unrealized gains and losses excluded from earnings and reported in a separate component of shareholders' equity."
"Payments to Acquire Debt Securities, Available-for-sale"	"Amount of cash outflow to acquire investment in debt security measured at fair value with change in fair value recognized in other comprehensive income (available-for-sale)."
"Payments to Acquire Businesses, Net of Cash Acquired"	"The cash outflow associated with the acquisition of a business, net of the cash acquired from the purchase."
"Payments to Acquire Intangible Assets"	"The cash outflow to acquire asset without physical form usually arising from contractual or other legal rights, excluding goodwill."
"Payments to Acquire Other Investments"	"Amount of cash outflow to acquire investments classified as other."
"Payments to Acquire Productive Assets"	"The cash outflow for purchases of and capital improvements on property, plant and equipment (capital expenditures), software, and other intangible assets."
"Payments to Acquire Property, Plant, and Equipment"	"The cash outflow associated with the acquisition of long-lived, physical assets that are used in the normal conduct of business to produce goods and services and not intended for resale; includes cash outflows to pay for construction of self-constructed assets."
"Preferred Stock, Shares Authorized"	"The maximum number of nonredeemable preferred shares (or preferred stock redeemable solely at the option of the issuer) permitted to be issued by an entity's charter and bylaws."
"Prepaid Expense Other, Noncurrent"	"Carrying amount as of the balance sheet date of amounts paid in advance which will be charged against earnings in periods after one year or beyond the operating cycle, if longer."
"Proceeds from Issuance of Common Stock"	"The cash inflow from the additional capital contribution to the entity."
"Proceeds from Issuance of Long-term Debt"	"The cash inflow from a debt initially having maturity due after one year or beyond the operating cycle, if longer."
"Proceeds from Maturities, Prepayments and Calls of Debt Securities, Available-for-sale"	"Amount of cash inflow from maturity, prepayment and call of investment in debt security measured at fair value with change in fair value recognized in other comprehensive income (available-for-sale)."
"Proceeds from Other Short-term Debt"	"Amount of cash inflow from short-term debt classified as other."
"Proceeds from (Payments for) Other Financing Activities"	"Amount of cash inflow (outflow) from financing activities classified as other."
"Proceeds from (Repayments of) Commercial Paper"	"The net cash inflow or cash outflow from issuing (borrowing) and repaying commercial paper."
"Proceeds from (Repayments of) Short-term Debt"	"The net cash inflow or outflow for borrowing having initial term of repayment within one year or the normal operating cycle, if longer."
"Proceeds from (Repayments of) Short-term Debt, Maturing in More than Three Months"	"The cash inflow from a borrowing net of the cash outflow from repayment of a borrowing having initial term of repayment of more than three months but less than one year or one operating cycle (if the normal cycle is more than one year)."
"Proceeds from (Repayments of) Short-term Debt, Maturing in Three Months or Less"	"The cash inflow from a borrowing net of the cash outflow from repayment of a borrowing having initial term of repayment within three months."
"Proceeds from Sale and Maturity of Other Investments"	"The cash inflow associated with the sale and maturity (principal being due) of other investments, prepayment and call (request of early payment) of other investments not otherwise defined in the taxonomy."
"Proceeds from Sale of Available-for-sale Securities"	"The cash inflow associated with the sale of debt and equity securities classified as available-for-sale securities."
"Proceeds from Sale of Debt Securities, Available-for-sale"	"Amount of cash inflow from sale of investment in debt security measured at fair value with change in fair value recognized in other comprehensive income (available-for-sale)."
"Proceeds from Short-term Debt, Maturing in More than Three Months"	"The cash inflow from a borrowing having initial term of repayment of more than three months but less than one year or one operating cycle (if the normal cycle is more than one year)."
"Product Warranty Accrual, Current"	"Carrying value as of the balance sheet date of obligations incurred through that date and payable for estimated claims under standard and extended warranty protection rights granted to customers. For classified balance sheets, represents the current portion of the liabilities (due within one year or within the normal operating cycle if longer)."
"Standard and Extended Product Warranty Accrual, Decrease for Payments"	"Amount of decrease in the standard and extended product warranty accrual from payments made in cash or in kind to satisfy claims under the terms of the standard and extended product warranty."
"Standard and Extended Product Warranty Accrual, Increase for Warranties Issued"	"Amount of increase in the standard and extended product warranty accrual from warranties issued."
"Product Warranty Expense"	"The expense charged against earnings for the period pertaining to standard and extended warranties on the entity's goods and services granted to customers."
"Property, Plant and Equipment, Gross"	"Amount before accumulated depreciation, depletion and amortization of physical assets used in the normal conduct of business and not intended for resale. Examples include, but are not limited to, land, buildings, machinery and equipment, office equipment, and furniture and fixtures."
"Property, Plant and Equipment, Net"	"Amount after accumulated depreciation, depletion and amortization of physical assets used in the normal conduct of business to produce goods and services and not intended for resale. Examples include, but are not limited to, land, buildings, machinery and equipment, office equipment, and furniture and fixtures."
"Reclassification from Accumulated Other Comprehensive Income, Current Period, before Tax"	"Amount before tax of reclassification adjustments of other comprehensive income (loss)."
"Reclassification from Accumulated Other Comprehensive Income, Current Period, Net of Tax"	"Amount after tax of reclassification adjustments of other comprehensive income (loss)."
"Reclassification from AOCI, Current Period, before Tax, Attributable to Parent"	"Amount before tax of reclassification adjustments of other comprehensive income (loss) attributable to parent."
"Repayments of Long-term Debt"	"The cash outflow for debt initially having maturity due after one year or beyond the normal operating cycle, if longer."
"Repayments of Other Short-term Debt"	"Amount of cash outflow for the payment of debt classified as other, maturing within one year or the operating cycle, if longer."
"Repayments of Short-term Debt, Maturing in More than Three Months"	"The cash outflow from a repayment of a borrowing having initial term of repayment of more than three months but less than one year or one operating cycle (if the normal cycle is more than one year)."
"Research and Development Expense"	"The aggregate costs incurred (1) in a planned search or critical investigation aimed at discovery of new knowledge with the hope that such knowledge will be useful in developing a new product or service, a new process or technique, or in bringing about a significant improvement to an existing product or process; or (2) to translate research findings or other knowledge into a plan or design for a new product or process or for a significant improvement to an existing product or process whether intended for sale or the entity's use, during the reporting period charged to research and development projects, including the costs of developing computer software up to the point in time of achieving technological feasibility, and costs allocated in accounting for a business combination to in-process projects deemed to have no alternative future use."
"Restricted Cash"	"Amount of cash restricted as to withdrawal or usage. Cash includes, but is not limited to, currency on hand, demand deposits with banks or financial institutions, and other accounts with general characteristics of demand deposits."
"Restricted Cash and Cash Equivalents, Current"	"Amount of cash and cash equivalents restricted as to withdrawal or usage, classified as current. Cash includes, but is not limited to, currency on hand, demand deposits with banks or financial institutions, and other accounts with general characteristics of demand deposits. Cash equivalents include, but are not limited to, short-term, highly liquid investments that are both readily convertible to known amounts of cash and so near their maturity that they present insignificant risk of changes in value because of changes in interest rates."
"Restricted Cash and Cash Equivalents, Noncurrent"	"Amount of cash and cash equivalents restricted as to withdrawal or usage, classified as noncurrent. Cash includes, but is not limited to, currency on hand, demand deposits with banks or financial institutions, and other accounts with general characteristics of demand deposits. Cash equivalents include, but are not limited to, short-term, highly liquid investments that are both readily convertible to known amounts of cash and so near their maturity that they present insignificant risk of changes in value because of changes in interest rates."
"Restricted Investments"	"Investments which are not defined as or included in marketable (debt, equity, or other) securities whose use is restricted in whole or in part, generally by contractual agreements or regulatory requirements. For use in an unclassified balance sheet."
"Retained Earnings (Accumulated Deficit)"	"The cumulative amount of the reporting entity's undistributed earnings or deficit."
"Revenue from Contract with Customer, Excluding Assessed Tax"	"Amount, excluding tax collected from customer, of revenue from satisfaction of performance obligation by transferring promised good or service to customer. Tax collected from customer is tax assessed by governmental authority that is both imposed on and concurrent with specific revenue-producing transaction, including, but not limited to, sales, use, value added and excise."
"Revenues"	"Amount of revenue recognized from goods sold, services rendered, insurance premiums, or other activities that constitute an earning process. Includes, but is not limited to, investment and interest income before deduction of interest expense when recognized as a component of revenue, and sales and trading gain (loss)."
"Revenue, Net (Deprecated 2018-01-31)"	"Total revenue from sale of goods and services rendered during the reporting period, in the normal course of business, reduced by sales returns and allowances, and sales discounts."
"Sales Revenue, Services, Other (Deprecated 2018-01-31)"	"Amount before allowances and discounts of service revenue classified as other."
"Securities Sold under Agreements to Repurchase, Fair Value of Collateral"	"Fair value of securities pledged as collateral against securities sold under agreement to repurchase."
"Segment Reporting Information, Operating Income (Loss) (Deprecated 2011-01-31)"	"Amount of income or loss for the reportable segment before unusual Items, equity method income or loss, income taxes, and extraordinary items."
"Segment Reporting, Reconciling Items, Assets (Deprecated 2011-01-31)"	"Total of reconciling items between total reportable segments' assets and consolidated entity assets."
"Segment Reporting, Segment Assets (Deprecated 2011-01-31)"	"Total assets for reportable segments."
"Selling, General and Administrative Expense"	"The aggregate total costs related to selling a firm's product and services, as well as all other general and administrative expenses. Direct selling expenses (for example, credit, warranty, and advertising) are expenses that can be directly linked to the sale of specific products. Indirect selling expenses are expenses that cannot be directly linked to the sale of specific products, for example telephone expenses, Internet, and postal charges. General and administrative expenses include salaries of non-sales personnel, rent, utilities, communication, etc."
"Share-based Payment Arrangement, Noncash Expense"	"Amount of noncash expense for share-based payment arrangement."
"Share-based Compensation Arrangement by Share-based Payment Award, Equity Instruments Other than Options, Forfeited in Period"	"The number of equity-based payment instruments, excluding stock (or unit) options, that were forfeited during the reporting period."
"Share-based Compensation Arrangement by Share-based Payment Award, Equity Instruments Other than Options, Forfeited in Period, Weighted Average Grant Date Fair Value (Deprecated 2012-01-31)"	"The weighted average fair value as of the grant date of equity-based award plans other than stock (unit) option plans that were not exercised or put into effect during the reporting period as a result of the occurrence of a terminating event specified in the contractual agreement of the plan."
"Share-based Compensation Arrangement by Share-based Payment Award, Equity Instruments Other than Options, Forfeitures, Weighted Average Grant Date Fair Value"	"Weighted average fair value as of the grant date of equity-based award plans other than stock (unit) option plans that were not exercised or put into effect as a result of the occurrence of a terminating event."
"Share-based Compensation Arrangement by Share-based Payment Award, Equity Instruments Other than Options, Grants in Period"	"The number of grants made during the period on other than stock (or unit) option plans (for example, phantom stock or unit plan, stock or unit appreciation rights plan, performance target plan)."
"Share-based Compensation Arrangement by Share-based Payment Award, Equity Instruments Other than Options, Grants in Period, Weighted Average Grant Date Fair Value"	"The weighted average fair value at grant date for nonvested equity-based awards issued during the period on other than stock (or unit) option plans (for example, phantom stock or unit plan, stock or unit appreciation rights plan, performance target plan)."
"Share-based Compensation Arrangement by Share-based Payment Award, Equity Instrument Other than Option, Nonvested, Intrinsic Value"	"Per share or unit weighted-average intrinsic value of nonvested award under share-based payment arrangement. Excludes share and unit options."
"Share-based Compensation Arrangement by Share-based Payment Award, Equity Instruments Other than Options, Nonvested, Number"	"The number of non-vested equity-based payment instruments, excluding stock (or unit) options, that validly exist and are outstanding as of the balance sheet date."
"Share-based Compensation Arrangement by Share-based Payment Award, Equity Instruments Other than Options, Nonvested, Weighted Average Grant Date Fair Value"	"Per share or unit weighted-average fair value of nonvested award under share-based payment arrangement. Excludes share and unit options."
"Share-based Compensation Arrangement by Share-based Payment Award, Equity Instruments Other than Options, Vested in Period"	"The number of equity-based payment instruments, excluding stock (or unit) options, that vested during the reporting period."
"Share-based Compensation Arrangement by Share-based Payment Award, Equity Instruments Other than Options, Vested in Period, Fair Value"	"Fair value of share-based awards for which the grantee gained the right by satisfying service and performance requirements, to receive or retain shares or units, other instruments, or cash."
"Share-based Compensation Arrangement by Share-based Payment Award, Equity Instruments Other than Options, Vested in Period, Weighted Average Grant Date Fair Value"	"The weighted average fair value as of grant date pertaining to an equity-based award plan other than a stock (or unit) option plan for which the grantee gained the right during the reporting period, by satisfying service and performance requirements, to receive or retain shares or units, other instruments, or cash in accordance with the terms of the arrangement."
"Share-based Compensation Arrangement by Share-based Payment Award, Fair Value Assumptions, Expected Dividend Rate"	"The estimated dividend rate (a percentage of the share price) to be paid (expected dividends) to holders of the underlying shares over the option's term."
"Share-based Compensation Arrangement by Share-based Payment Award, Fair Value Assumptions, Expected Term (Deprecated 2012-01-31)"	"The period of time an equity-based award is expected to be outstanding. An equity-based award's expected term is generally determined based on, among other factors, the instrument's contractual term and the effects of employees' expected exercise and post-vesting employment termination behavior."
"Share-based Compensation Arrangement by Share-based Payment Award, Fair Value Assumptions, Risk Free Interest Rate"	"The risk-free interest rate assumption that is used in valuing an option on its own shares."
"Share-based Compensation Arrangement by Share-based Payment Award, Fair Value Assumptions, Weighted Average Volatility Rate"	"Rate of weighted-average expected volatility for award under share-based payment arrangement."
"Share-based Compensation Arrangement by Share-based Payment Award, Number of Shares Available for Grant"	"The difference between the maximum number of shares (or other type of equity) authorized for issuance under the plan (including the effects of amendments and adjustments), and the sum of: 1) the number of shares (or other type of equity) already issued upon exercise of options or other equity-based awards under the plan; and 2) shares (or other type of equity) reserved for issuance on granting of outstanding awards, net of cancellations and forfeitures, if applicable."
"Share-based Compensation Arrangement by Share-based Payment Award, Options, Exercisable, Intrinsic Value (Deprecated 2011-01-31)"	"The total dollar difference between fair values of the underlying shares reserved for issuance and exercise prices of vested portions of options outstanding and currently exercisable under the option plan as of the balance sheet date."
"Share-based Compensation Arrangement by Share-based Payment Award, Options, Exercisable, Number"	"The number of shares into which fully or partially vested stock options outstanding as of the balance sheet date can be currently converted under the option plan."
"Share-based Compensation Arrangement by Share-based Payment Award, Options, Exercisable, Weighted Average Exercise Price"	"The weighted-average price as of the balance sheet date at which grantees can acquire the shares reserved for issuance on vested portions of options outstanding and currently exercisable under the stock option plan."
"Share-based Compensation Arrangement by Share-based Payment Award, Options, Exercisable, Weighted Average Remaining Contractual Term (Deprecated 2012-01-31)"	"The weighted average period between the balance sheet date and expiration for all vested portions of options outstanding and currently exercisable (or convertible) under the plan, which may be expressed in a decimal value for number of years."
"Share-based Compensation Arrangement by Share-based Payment Award, Options, Exercises in Period (Deprecated 2011-01-31)"	"The decrease in the number of reserved shares that could potentially be issued attributable to the exercise or conversion during the reporting period of previously issued stock options under the option plan."
"Share-based Compensation Arrangement by Share-based Payment Award, Options, Exercises in Period, Intrinsic Value"	"Amount of accumulated difference between fair value of underlying shares on dates of exercise and exercise price on options exercised (or share units converted) into shares."
"Share-based Compensation Arrangement by Share-based Payment Award, Options, Exercises in Period, Weighted Average Exercise Price (Deprecated 2012-01-31)"	"The weighted average price at which option holders acquired shares when converting their stock options into shares under the plan during the reporting period."
"Share-based Compensation Arrangement by Share-based Payment Award, Options, Forfeitures in Period"	"The number of shares under options that were cancelled during the reporting period as a result of occurrence of a terminating event specified in contractual agreements pertaining to the stock option plan."
"Share-based Compensation Arrangement by Share-based Payment Award, Options, Forfeitures in Period, Weighted Average Exercise Price (Deprecated 2012-01-31)"	"The weighted average price at which grantees could have acquired the underlying shares with respect to stock options that were terminated during the reporting period due to noncompliance with plan terms during the reporting period."
"Share-based Compensation Arrangement by Share-based Payment Award, Options, Grants in Period, Net of Forfeitures"	"Net number of share options (or share units) granted during the period."
"Share-based Compensation Arrangement by Share-based Payment Award, Options, Grants in Period, Weighted Average Exercise Price (Deprecated 2012-01-31)"	"The weighted average price as of the balance sheet date at which grantees can acquire the shares reserved for issuance on stock options awarded under the plan during the reporting period."
"Share-based Compensation Arrangement by Share-based Payment Award, Options, Grants in Period, Weighted Average Grant Date Fair Value"	"The weighted average grant-date fair value of options granted during the reporting period as calculated by applying the disclosed option pricing methodology."
"Share-based Compensation Arrangement by Share-based Payment Award, Options, Other Increases (Decreases) in Period"	"The addition or reduction in the number of reserved shares that could potentially be issued under the option plan attributable to reasons other than grants, exercises, forfeitures, and expirations during the reporting period."
"Share-based Compensation Arrangement by Share-based Payment Award, Options, Outstanding, Intrinsic Value"	"Amount by which the current fair value of the underlying stock exceeds the exercise price of options outstanding."
"Share-based Compensation Arrangement by Share-based Payment Award, Options, Outstanding, Number"	"Number of options outstanding, including both vested and non-vested options."
"Share-based Compensation Arrangement by Share-based Payment Award, Options, Outstanding, Weighted Average Exercise Price"	"Weighted average price at which grantees can acquire the shares reserved for issuance under the stock option plan."
"Share-based Compensation Arrangement by Share-based Payment Award, Options, Outstanding, Weighted Average Remaining Contractual Term (Deprecated 2011-01-31)"	"The weighted average period between the balance sheet date and expiration for all awards outstanding under the plan, which may be expressed in a decimal value for number of years."
"Share-based Compensation Arrangement by Share-based Payment Award, Options, Vested and Expected to Vest, Outstanding, Number"	"Number of fully vested and expected to vest options outstanding that can be converted into shares under option plan. Includes, but is not limited to, unvested options for which requisite service period has not been rendered but that are expected to vest based on achievement of performance condition, if forfeitures are recognized when they occur."
"Share-based Compensation Arrangements by Share-based Payment Award, Options, Exercises in Period, Weighted Average Exercise Price"	"Weighted average price at which option holders acquired shares when converting their stock options into shares."
"Share-based Compensation Arrangements by Share-based Payment Award, Options, Forfeitures in Period, Weighted Average Exercise Price"	"Weighted average price at which grantees could have acquired the underlying shares with respect to stock options that were terminated."
"Share-based Compensation Arrangements by Share-based Payment Award, Options, Grants in Period, Weighted Average Exercise Price"	"Weighted average per share amount at which grantees can acquire shares of common stock by exercise of options."
"Share-based Compensation Arrangement by Share-based Payment Award, Equity Instruments Other than Options, Aggregate Intrinsic Value, Nonvested"	"Intrinsic value of nonvested award under share-based payment arrangement. Excludes share and unit options."
"Share-based Compensation Arrangement by Share-based Payment Award, Options, Exercisable, Intrinsic Value"	"Amount of difference between fair value of the underlying shares reserved for issuance and exercise price of vested portions of options outstanding and currently exercisable."
"Share-based Compensation Arrangement by Share-based Payment Award, Options, Outstanding, Weighted Average Remaining Contractual Term (Deprecated 2012-01-31)"	"The weighted average period between the balance sheet date and expiration for all awards outstanding under the plan, which may be expressed in a decimal value for number of years."
"Share-based Payment Arrangement, Shares Withheld for Tax Withholding Obligation"	"Number of shares used to settle grantee's tax withholding obligation for award under share-based payment arrangement."
"Short-term Debt, Weighted Average Interest Rate, at Point in Time"	"Weighted average interest rate of short-term debt outstanding calculated at point in time."
"Significant (Increase) Decrease in Unrecognized Tax Benefits is Reasonably Possible, Estimated Range of Change, Lower Bound (Deprecated 2015-01-31)"	"Amount of (increase) decrease reasonably possible in the estimated lower bound of the unrecognized tax benefit for a tax position taken or expected to be taken."
"Significant (Increase) Decrease in Unrecognized Tax Benefits is Reasonably Possible, Estimated Range of Change, Upper Bound (Deprecated 2015-01-31)"	"Amount of (increase) decrease reasonably possible in the estimated upper bound of the unrecognized tax benefit for a tax position taken or expected to be taken."
"Standard Product Warranty Accrual"	"Amount as of the balance sheet date of the aggregate standard product warranty liability. Does not include the balance for the extended product warranty liability."
"Standard Product Warranty Accrual, Decrease for Payments"	"Amount of decrease in the standard product warranty accrual from payments made in cash or in kind to satisfy claims under the terms of the standard product warranty. Excludes extended product warranties."
"Standard Product Warranty Accrual, Increase for Warranties Issued"	"Amount of increase in the standard product warranty accrual from warranties issued. Excludes extended product warranties."
"State and Local Income Tax Expense (Benefit), Continuing Operations"	"Amount of state and local current and deferred income tax expense (benefit) attributable to continuing operations."
"Stockholders' Equity Attributable to Parent"	"Total of all stockholders' equity (deficit) items, net of receivables from officers, directors, owners, and affiliates of the entity which are attributable to the parent. The amount of the economic entity's stockholders' equity attributable to the parent excludes the amount of stockholders' equity which is allocable to that ownership interest in subsidiary equity which is not attributable to the parent (noncontrolling interest, minority interest). This excludes temporary equity and is sometimes called permanent equity."
"Stockholders' Equity Note, Stock Split, Conversion Ratio"	"Ratio applied to the conversion of stock split, for example but not limited to, one share converted to two or two shares converted to one."
"Share-based Compensation Arrangement by Share-based Payment Award, Options, Exercises in Period"	"Number of share options (or share units) exercised during the current period."
"Stock Issued During Period, Value, Acquisitions"	"Value of stock issued pursuant to acquisitions during the period."
"Shares Issued, Value, Share-based Payment Arrangement, after Forfeiture"	"Value, after forfeiture, of shares issued under share-based payment arrangement. Excludes employee stock ownership plan (ESOP)."
"Stock Repurchased and Retired During Period, Shares"	"Number of shares that have been repurchased and retired during the period."
"Stock Repurchased and Retired During Period, Value"	"Equity impact of the value of stock that has been repurchased and retired during the period. The excess of the purchase price over par value can be charged against retained earnings (once the excess is fully allocated to additional paid in capital)."
"Stock Repurchase Program, Authorized Amount (Deprecated 2014-01-31)"	"Amount of a stock repurchase plan authorized by an entity's Board of Directors."
"Stock Repurchase Program, Authorized Amount"	"Amount of stock repurchase plan authorized."
"Tax Adjustments, Settlements, and Unusual Provisions"	"Amount of increase (decrease) to previously recorded tax expense. Includes, but is not limited to, significant settlements of income tax disputes, and unusual tax positions or infrequent actions taken by the entity, including tax assessment reversal, and IRS tax settlement."
"Taxes Payable, Current"	"Carrying value as of the balance sheet date of obligations incurred and payable for statutory income, sales, use, payroll, excise, real, property and other taxes. Used to reflect the current portion of the liabilities (due within one year or within the normal operating cycle if longer)."
"Derivatives used in Net Investment Hedge, Net of Tax"	"Amount, after tax, of cumulative translation adjustment attributable to gain (loss) on foreign currency derivatives that are designated as, and are effective as, economic hedges of a net investment in a foreign entity."
"Treasury Stock, Value, Acquired, Cost Method"	"Equity impact of the cost of common and preferred stock that were repurchased during the period. Recorded using the cost method."
"Undistributed Earnings of Foreign Subsidiaries"	"Amount of undistributed earnings of foreign subsidiaries intended to be permanently reinvested outside the country of domicile."
"Unrecognized Tax Benefits"	"Amount of unrecognized tax benefits."
"Unrecognized Tax Benefits, Decrease Resulting from Prior Period Tax Positions"	"Amount of decrease in unrecognized tax benefits resulting from tax positions taken in prior period tax returns."
"Unrecognized Tax Benefits, Decrease Resulting from Settlements with Taxing Authorities"	"Amount of decrease in unrecognized tax benefits resulting from settlements with taxing authorities."
"Unrecognized Tax Benefits, Income Tax Penalties and Interest Accrued"	"Amount accrued for interest on an underpayment of income taxes and penalties related to a tax position claimed or expected to be claimed in the tax return."
"Unrecognized Tax Benefits, Income Tax Penalties and Interest Expense"	"Amount of expense for interest on an underpayment of income taxes and penalties related to a tax position claimed or expected to be claimed in the tax return."
"Unrecognized Tax Benefits, Increase Resulting from Current Period Tax Positions"	"Amount of increase in unrecognized tax benefits resulting from tax positions that have been or will be taken in current period tax return."
"Unrecognized Tax Benefits, Increase Resulting from Prior Period Tax Positions"	"Amount of increase in unrecognized tax benefits resulting from tax positions taken in prior period tax returns."
"Unrecognized Tax Benefits, Period Increase (Decrease)"	"Amount of increase (decrease) in unrecognized tax benefits attributable to uncertain tax positions taken in tax returns."
"Unrecognized Tax Benefits, Reduction Resulting from Lapse of Applicable Statute of Limitations"	"Amount of decrease in unrecognized tax benefits resulting from lapses of applicable statutes of limitations."
"Unrecognized Tax Benefits that Would Impact Effective Tax Rate"	"The total amount of unrecognized tax benefits that, if recognized, would affect the effective tax rate."
"Unrecorded Unconditional Purchase Obligation, to be Paid, Year Five"	"Amount of fixed and determinable portion of unrecorded unconditional purchase obligation to be paid in fifth fiscal year following current fiscal year. Excludes interim and annual periods when interim periods are reported from current statement of financial position date (rolling approach)."
"Unrecorded Unconditional Purchase Obligation, to be Paid, Year One"	"Amount of fixed and determinable portion of unrecorded unconditional purchase obligation to be paid in next fiscal year following current fiscal year. Excludes interim and annual periods when interim periods are reported from current statement of financial position date (rolling approach)."
"Unrecorded Unconditional Purchase Obligation, to be Paid, Year Four"	"Amount of fixed and determinable portion of unrecorded unconditional purchase obligation to be paid in fourth fiscal year following current fiscal year. Excludes interim and annual periods when interim periods are reported from current statement of financial position date (rolling approach)."
"Unrecorded Unconditional Purchase Obligation, to be Paid, Year Two"	"Amount of fixed and determinable portion of unrecorded unconditional purchase obligation to be paid in second fiscal year following current fiscal year. Excludes interim and annual periods when interim periods are reported from current statement of financial position date (rolling approach)."
"Unrecorded Unconditional Purchase Obligation, to be Paid, Year Three"	"Amount of fixed and determinable portion of unrecorded unconditional purchase obligation to be paid in third fiscal year following current fiscal year. Excludes interim and annual periods when interim periods are reported from current statement of financial position date (rolling approach)."
"Unrecorded Unconditional Purchase Obligation"	"Amount of the unrecorded obligation to transfer funds in the future for fixed or minimum amounts or quantities of goods or services at fixed or minimum prices (for example, as in take-or-pay contracts or throughput contracts)."
"Unrecorded Unconditional Purchase Obligation, to be Paid, after Year Five"	"Amount of fixed and determinable portion of unrecorded unconditional purchase obligation to be paid after fifth fiscal year following current fiscal year. Excludes interim and annual periods when interim periods are reported from current statement of financial position date (rolling approach)."
"Variable Lease, Cost"	"Amount of variable lease cost, excluded from lease liability, recognized when obligation for payment is incurred for finance and operating leases."
"Weighted Average Number Diluted Shares Outstanding Adjustment"	"The sum of dilutive potential common shares or units used in the calculation of the diluted per-share or per-unit computation."
"Weighted Average Number of Shares Outstanding, Diluted"	"The average number of shares or units issued and outstanding that are used in calculating diluted EPS or earnings per unit (EPU), determined based on the timing of issuance of shares or units in the period."
"Weighted Average Number of Shares Outstanding, Basic"	"Number of [basic] shares or units, after adjustment for contingently issuable shares or units and other shares or units not deemed outstanding, determined by relating the portion of time within a reporting period that common shares or units have been outstanding to the total time in that period."
"Deferred Tax Assets, Other Comprehensive Loss"	"Amount before allocation of valuation allowances of deferred tax asset attributable to deductible temporary differences from unrealized losses in other comprehensive income."
NA	NA
"Debt Securities, Available-for-sale, Restricted"	"Amount of restricted investment in debt security measured at fair value with change in fair value recognized in other comprehensive income (available-for-sale)."
"Inventory, Work in Process and Raw Materials, Net of Reserves"	"The aggregate carrying amount, net of valuation reserves and adjustments, as of the balance sheet date of items which are partially completed at the time of measurement and unprocessed items that will go through the production process and become part of the final product. This element may be used when the reporting entity combines work in process and raw materials into an aggregate amount."
"Unrecorded Unconditional Purchase Obligation, to be Paid, Remainder of Fiscal Year"	"Amount of fixed and determinable portion of unrecorded unconditional purchase obligation to be paid in remainder of current fiscal year."
"Inventory, Raw Materials and Purchased Parts, Net of Reserves"	"Carrying amount, net of valuation reserves and adjustments, as of the balance sheet date of items purchased for use as components of a finished product or pieces of machinery and equipment plus any items in their natural and unrefined state. This element may be used when the reporting entity combines raw materials and purchased parts into an aggregate amount."
"Hedged Asset, Fair Value Hedge"	"Amount of asset hedged in fair value hedging relationship."
"Hedged Liability, Fair Value Hedge"	"Amount of liability hedged in fair value hedging relationship."
"Deferred Income Tax Assets, Net"	"Amount, after allocation of valuation allowances and deferred tax liability, of deferred tax asset attributable to deductible differences and carryforwards, with jurisdictional netting."
"Deferred Tax Liabilities, Property, Plant and Equipment"	"Amount of deferred tax liability attributable to taxable temporary differences from property, plant, and equipment."
"Incremental Common Shares Attributable to Dilutive Effect of Share-based Payment Arrangements"	"Additional shares included in the calculation of diluted EPS as a result of the potentially dilutive effect of share based payment arrangements using the treasury stock method."
"Other Assets, Miscellaneous, Noncurrent"	"Amount of other miscellaneous assets expected to be realized or consumed after one year or normal operating cycle, if longer."
